family,acceptedNameUsage,valid,invalid,validated,not_validated,sig_ok,sig_nok,no_sig,used,unused,total,eoo,aoo
Poaceae,"Glaziophyton mirabile",8,13,21,5,21,5,0,8,18,26,"391,5km²","36,0km²"
Thismiaceae,"Thismia glaziovii",0,0,0,7,0,1,6,0,7,7,n/a,n/a
COMMELINACEAE,"Dichorisandra picta",3,1,4,0,3,1,0,3,1,4,"53,46km²","12,0km²"
Bromeliaceae,"Neoregelia paratiensis",1,1,2,0,2,0,0,1,1,2,"275,36km²","4,0km²"
Poaceae,"Chusquea sclerophylla",3,8,11,0,11,0,0,3,8,11,"273,89km²","4,0km²"
Gesneriaceae,"Besleria macahensis",0,0,0,0,0,0,0,0,0,0,n/a,n/a
CACTACEAE,"Rhipsalis triangularis",14,0,14,0,13,1,0,13,1,14,"0,31km²","4,0km²"
Myrtaceae,"Myrcia innovans",3,10,13,3,6,9,1,1,15,16,"4,11km²","12,0km²"
Amaryllidaceae,"Worsleya procera",0,0,0,61,43,18,0,0,61,61,"41,91km²","28,0km²"
ORCHIDACEAE,"Pabstiella dracula",3,0,3,0,3,0,0,3,0,3,"496,88km²","8,0km²"
Acanthaceae,"Aphelandra stephanophysa",4,2,6,0,3,3,0,3,3,6,"43,84km²","12,0km²"
Acanthaceae,"Justicia meyeniana",24,10,34,0,32,2,0,23,11,34,"5.681,99km²","68,0km²"
Amaryllidaceae,"Griffinia intermedia",0,2,2,9,10,1,0,0,11,11,"283,3km²","20,0km²"
Orchidaceae,"Pabstiella pantherina",0,0,0,0,0,0,0,0,0,0,n/a,n/a
ACANTHACEAE,"Aphelandra bradeana",2,3,5,0,4,1,0,2,3,5,"274,21km²","4,0km²"
ACANTHACEAE,"Aphelandra rigida",3,4,7,0,2,5,0,1,6,7,"273,16km²","4,0km²"
ACANTHACEAE,"Herpetacanthus delicatus",1,1,2,0,1,1,0,1,1,2,"274,82km²","4,0km²"
ACANTHACEAE,"Herpetacanthus parvispica",1,0,1,0,1,0,0,1,0,1,"274,22km²","4,0km²"
ACANTHACEAE,"Justicia itatiaiensis",2,0,2,0,2,0,0,2,0,2,"274,21km²","4,0km²"
ACANTHACEAE,"Justicia nervata",8,3,11,0,10,1,0,8,3,11,"344,72km²","12,0km²"
ACANTHACEAE,"Justicia polita",32,4,36,0,36,0,0,32,4,36,"2.978,94km²","60,0km²"
ACANTHACEAE,"Staurogyne brachiata",5,3,8,0,5,3,0,4,4,8,"86,46km²","12,0km²"
ACANTHACEAE,"Staurogyne euryphylla",4,5,9,0,7,2,0,3,6,9,"253,58km²","12,0km²"
AMARYLLIDACEAE,"Griffinia rochae",0,0,0,2,1,1,0,0,2,2,"274,32km²","4,0km²"
ANEMIACEAE,"Anemia candidoi",1,1,2,0,2,0,0,1,1,2,n/a,n/a
ANNONACEAE,"Annona ferruginea",3,1,4,0,3,1,0,3,1,4,"4,48km²","8,0km²"
ANNONACEAE,"Annona parviflora",40,34,74,0,55,19,0,35,39,74,"7.237,28km²","72,0km²"
ANNONACEAE,"Duguetia microphylla",8,8,16,0,11,5,0,8,8,16,"283,33km²","16,0km²"
ANNONACEAE,"Duguetia pohliana",5,7,12,0,8,4,0,4,8,12,"611,26km²","16,0km²"
ANNONACEAE,"Hornschuchia alba",16,8,24,0,19,5,0,12,12,24,"23,54km²","24,0km²"
ANNONACEAE,"Trigynaea axilliflora",13,11,24,0,22,2,0,12,12,24,"791,58km²","24,0km²"
ANNONACEAE,"Unonopsis riedeliana",4,2,6,0,3,3,0,3,3,6,"1.869,73km²","12,0km²"
ANTHOCEROTACEAE,"Anthoceros lamellatus",1,1,2,0,2,0,0,1,1,2,"273,82km²","4,0km²"
APIACEAE,"Eryngium fluminense",7,7,14,2,10,6,0,5,11,16,"178,4km²","16,0km²"
APOCYNACEAE,"Aspidosperma compactinervium",7,43,50,8,31,27,0,4,54,58,"414.221,57km²","40,0km²"
APOCYNACEAE,"Aspidosperma ingratum",0,11,11,2,10,3,0,0,13,13,"273,55km²","4,0km²"
APOCYNACEAE,"Cynanchum brasiliense",3,3,6,0,4,2,0,2,4,6,"519,12km²","8,0km²"
APOCYNACEAE,"Ditassa fontellae",0,2,2,0,2,0,0,0,2,2,n/a,n/a
APOCYNACEAE,"Ditassa guilleminiana",9,3,12,3,10,5,0,8,7,15,"2.700,99km²","28,0km²"
APOCYNACEAE,"Ditassa imbricata",2,7,9,0,8,1,0,1,8,9,"273,89km²","4,0km²"
APOCYNACEAE,"Ditassa maricaensis",47,2,49,0,49,0,0,47,2,49,"1.163,3km²","56,0km²"
APOCYNACEAE,"Ditassa subumbellata",3,0,3,0,3,0,0,3,0,3,"549,73km²","8,0km²"
APOCYNACEAE,"Forsteronia linearis",0,2,2,0,0,2,0,0,2,2,n/a,n/a
APOCYNACEAE,"Gonolobus dorothyanus",2,3,5,0,5,0,0,2,3,5,"274,98km²","4,0km²"
APOCYNACEAE,"Macroditassa laxa",4,3,7,0,7,0,0,4,3,7,"285,2km²","16,0km²"
APOCYNACEAE,"Mandevilla crassinoda",11,2,13,4,12,5,0,9,8,17,"328.469,16km²","32,0km²"
APOCYNACEAE,"Marsdenia glaziovii",1,10,11,0,2,9,0,0,11,11,n/a,n/a
APOCYNACEAE,"Matelea fournieri",5,7,12,1,13,0,0,5,8,13,"60.262,53km²","20,0km²"
APOCYNACEAE,"Matelea quinquedentata",2,12,14,1,14,1,0,2,13,15,n/a,n/a
APOCYNACEAE,"Monsanima tinguaensis",0,0,0,0,0,0,0,0,0,0,n/a,n/a
APOCYNACEAE,"Orthosia arenosa",13,15,28,1,17,12,0,11,18,29,"2.291,94km²","28,0km²"
APOCYNACEAE,"Orthosia umbrosa",0,6,6,0,0,6,0,0,6,6,n/a,n/a
APOCYNACEAE,"Oxypetalum costae",2,0,2,0,2,0,0,2,0,2,"318,73km²","8,0km²"
APOCYNACEAE,"Oxypetalum lutescens",1,6,7,3,7,3,0,1,9,10,"273,39km²","4,0km²"
APOCYNACEAE,"Oxypetalum schottii",5,6,11,2,7,6,0,4,9,13,"369,95km²","20,0km²"
AQUIFOLIACEAE,"Ilex cognata",1,0,1,0,0,1,0,0,1,1,n/a,n/a
AQUIFOLIACEAE,"Ilex friburgensis",1,6,7,0,1,6,0,1,6,7,"273,39km²","4,0km²"
AQUIFOLIACEAE,"Ilex glazioviana",1,4,5,0,2,3,0,1,4,5,"273,89km²","4,0km²"
AQUIFOLIACEAE,"Ilex longipetiolata",7,5,12,0,4,8,0,2,10,12,"547,27km²","8,0km²"
AQUIFOLIACEAE,"Ilex organensis",2,0,2,0,1,1,0,1,1,2,"273,83km²","4,0km²"
AQUIFOLIACEAE,"Ilex schwackeana",2,5,7,0,4,3,0,2,5,7,"545,73km²","8,0km²"
AQUIFOLIACEAE,"Ilex virgata",1,1,2,0,0,2,0,0,2,2,n/a,n/a
ARACEAE,"Anthurium aduncum",0,1,1,0,0,1,0,0,1,1,n/a,n/a
ARACEAE,"Anthurium augustinum",2,10,12,14,17,9,0,2,24,26,"11.934,28km²","24,0km²"
ARACEAE,"Anthurium binotii",10,14,24,2,18,8,0,10,16,26,"4.975,86km²","36,0km²"
ARACEAE,"Anthurium bragae",5,5,10,2,12,0,0,5,7,12,"16,22km²","20,0km²"
ARACEAE,"Anthurium harrisii",0,0,0,272,230,42,0,0,272,272,"400.375,35km²","424,0km²"
ARACEAE,"Anthurium laucheanum",7,14,21,1,17,5,0,7,15,22,"836,6km²","20,0km²"
ARACEAE,"Anthurium lhotzkyanum",23,28,51,9,52,8,0,23,37,60,"6.118,85km²","80,0km²"
ARACEAE,"Anthurium lucidum",8,28,36,5,32,9,0,8,33,41,"567,15km²","20,0km²"
ARACEAE,"Anthurium luschnathianum",24,13,37,1,37,1,0,24,14,38,"25.236,21km²","44,0km²"
ARACEAE,"Anthurium nitidulum",0,5,5,2,2,5,0,0,7,7,n/a,n/a
ARACEAE,"Anthurium simonii",11,9,20,0,20,0,0,11,9,20,"91,52km²","16,0km²"
ARACEAE,"Anthurium validinervium",1,3,4,1,4,1,0,1,4,5,"372,72km²","8,0km²"
ARACEAE,"Asterostigma concinnum",0,5,5,0,4,1,0,0,5,5,n/a,n/a
ARACEAE,"Philodendron alternans",4,4,8,0,7,1,0,4,4,8,"267,63km²","16,0km²"
ARACEAE,"Philodendron fragile",9,10,19,0,19,0,0,9,10,19,"231,45km²","20,0km²"
ARACEAE,"Philodendron millerianum",1,3,4,0,4,0,0,1,3,4,"273,45km²","4,0km²"
ARACEAE,"Philodendron nadruzianum",1,0,1,0,1,0,0,1,0,1,"272,44km²","4,0km²"
ARACEAE,"Wolffiella neotropica",3,5,8,0,8,0,0,3,5,8,"548,8km²","8,0km²"
ARALIACEAE,"Dendropanax heterophyllus",3,15,18,3,13,8,0,3,18,21,"2.774,95km²","12,0km²"
ARALIACEAE,"Dendropanax langsdorfii",23,14,37,2,33,6,0,20,19,39,"2.142,52km²","44,0km²"
ARALIACEAE,"Dendropanax trilobus",17,6,23,5,23,4,1,14,14,28,"1,22km²","8,0km²"
ARALIACEAE,"Hydrocotyle alpestris",5,0,5,0,4,1,0,4,1,5,"1,86km²","12,0km²"
ARALIACEAE,"Hydrocotyle bradei",4,2,6,2,8,0,0,4,4,8,"441,53km²","8,0km²"
ARALIACEAE,"Hydrocotyle ulei",5,0,5,1,6,0,0,5,1,6,"285,86km²","12,0km²"
ARALIACEAE,"Schefflera succinea",4,14,18,0,8,10,0,4,14,18,"663,63km²","12,0km²"
ARECACEAE,"Lytocaryum weddellianum",8,25,33,2,30,5,0,4,31,35,"5.694,34km²","24,0km²"
ARISTOLOCHIACEAE,"Aristolochia raja",18,0,18,16,30,3,1,18,16,34,"118.631,74km²","56,0km²"
ASPLENIACEAE,"Asplenium cariocanum",7,0,7,0,7,0,0,7,0,7,"3.587,92km²","16,0km²"
ASTERACEAE,"Austrocritonia rosea",6,0,6,3,9,0,0,6,3,9,"86,89km²","12,0km²"
ASTERACEAE,"Austrocritonia taunayana",5,2,7,1,8,0,0,5,3,8,"4.269,82km²","20,0km²"
ASTERACEAE,"Austroeupatorium petrophilum",0,1,1,0,1,0,0,0,1,1,n/a,n/a
ASTERACEAE,"Baccharis alpestris",4,3,7,1,6,2,0,3,5,8,"273,89km²","4,0km²"
ASTERACEAE,"Baccharis bifrons",12,1,13,1,11,3,0,11,3,14,"318,86km²","36,0km²"
ASTERACEAE,"Baccharis ciliata",7,8,15,1,15,1,0,7,9,16,"372,44km²","8,0km²"
ASTERACEAE,"Baccharis friburgensis",2,3,5,0,5,0,0,2,3,5,"460,59km²","8,0km²"
ASTERACEAE,"Baccharis pseudovaccinioides",9,6,15,0,13,2,0,8,7,15,"2,27km²","16,0km²"
ASTERACEAE,"Barrosoa viridiflora",0,1,1,0,0,1,0,0,1,1,n/a,n/a
ASTERACEAE,"Calea wedelioides",4,8,12,1,7,6,0,4,9,13,"3.051,72km²","12,0km²"
ASTERACEAE,"Critoniopsis magdalenae",2,0,2,0,2,0,0,2,0,2,"272,46km²","4,0km²"
ASTERACEAE,"Dasyphyllum cryptocephalum",7,12,19,1,9,11,0,7,13,20,"1.301,03km²","28,0km²"
ASTERACEAE,"Dasyphyllum leptacanthum",18,42,60,3,55,8,0,18,45,63,"2.814,04km²","32,0km²"
ASTERACEAE,"Gamochaeta grazielae",1,0,1,0,1,0,0,1,0,1,"274,21km²","4,0km²"
ASTERACEAE,"Graphistylis cuneifolia",9,2,11,2,13,0,0,9,4,13,"1,97km²","12,0km²"
ASTERACEAE,"Lepidaploa araujoa",3,0,3,0,3,0,0,3,0,3,"273,21km²","4,0km²"
ASTERACEAE,"Lepidaploa coulonioides",0,6,6,17,23,0,0,0,23,23,"93.546,07km²","44,0km²"
ASTERACEAE,"Lepidaploa obtusifolia",30,36,66,2,40,28,0,28,40,68,"736,49km²","36,0km²"
ASTERACEAE,"Lepidaploa persicifolia",35,33,68,1,43,26,0,33,36,69,"82.837,06km²","92,0km²"
ASTERACEAE,"Lessingianthus glaziovianus",11,12,23,0,13,10,0,9,14,23,"75,22km²","20,0km²"
ASTERACEAE,"Macropodina bradei",5,4,9,0,8,1,0,5,4,9,"1.709,36km²","16,0km²"
ASTERACEAE,"Mikania alexandreae",2,10,12,0,12,0,0,2,10,12,"481,5km²","8,0km²"
ASTERACEAE,"Mikania cabrerae",3,1,4,0,4,0,0,3,1,4,"62,69km²","12,0km²"
ASTERACEAE,"Mikania campos-portoana",6,5,11,0,11,0,0,6,5,11,"2.904,51km²","16,0km²"
ASTERACEAE,"Mikania casarettoi",2,2,4,0,1,3,0,1,3,4,"274,82km²","4,0km²"
ASTERACEAE,"Mikania hastifolia",5,1,6,0,3,3,0,3,3,6,"3.240,3km²","12,0km²"
ASTERACEAE,"Mikania paranahybensis",0,2,2,0,1,1,0,0,2,2,n/a,n/a
ASTERACEAE,"Mikania pteropoda",10,6,16,1,15,2,0,10,7,17,"877,42km²","32,0km²"
ASTERACEAE,"Mikania vauthieriana",11,11,22,0,20,2,0,10,12,22,"4.753,95km²","28,0km²"
ASTERACEAE,"Ophryosporus organensis",2,1,3,0,3,0,0,2,1,3,"273,89km²","4,0km²"
ASTERACEAE,"Piptocarpha verticillata",10,12,22,0,17,5,0,8,14,22,"2,46km²","16,0km²"
ASTERACEAE,"Senecio arctiifolius",3,2,5,2,6,1,0,3,4,7,"45,27km²","12,0km²"
ASTERACEAE,"Senecio malacophyllus",2,1,3,0,3,0,0,2,1,3,"274,03km²","4,0km²"
ASTERACEAE,"Senecio ramentaceus",2,12,14,1,3,12,0,2,13,15,"536,2km²","8,0km²"
ASTERACEAE,"Stevia dubia",0,3,3,0,0,3,0,0,3,3,n/a,n/a
ASTERACEAE,"Stevia organensis",11,17,28,0,26,2,0,11,17,28,"395,76km²","24,0km²"
ASTERACEAE,"Stevia verticillata",2,5,7,0,6,1,0,2,5,7,"545,93km²","8,0km²"
ASTERACEAE,"Trichogoniopsis podocarpa",21,29,50,0,38,12,0,20,30,50,"6.192,89km²","40,0km²"
ASTERACEAE,"Wunderlichia insignis",4,26,30,2,8,24,0,4,28,32,"1.210,77km²","20,0km²"
BEGONIACEAE,"Begonia acetosa",0,7,7,1,0,8,0,0,8,8,n/a,n/a
BEGONIACEAE,"Begonia acida",0,4,4,0,2,2,0,0,4,4,n/a,n/a
BEGONIACEAE,"Begonia aconitifolia",0,0,0,29,28,1,0,0,29,29,"1.946.525,4km²","72,0km²"
BEGONIACEAE,"Begonia antonietae",1,2,3,0,3,0,0,1,2,3,"273,88km²","4,0km²"
BEGONIACEAE,"Begonia cariocana",0,0,0,0,0,0,0,0,0,0,n/a,n/a
BEGONIACEAE,"Begonia cerasiphylla",0,0,0,0,0,0,0,0,0,0,n/a,n/a
BEGONIACEAE,"Begonia collaris",15,4,19,2,18,2,1,15,6,21,"51,55km²","24,0km²"
BEGONIACEAE,"Begonia concinna",13,9,22,0,18,4,0,12,10,22,"85,61km²","12,0km²"
BEGONIACEAE,"Begonia cordata",0,0,0,1,1,0,0,0,1,1,"273,38km²","4,0km²"
BEGONIACEAE,"Begonia declinata",0,0,0,0,0,0,0,0,0,0,n/a,n/a
BEGONIACEAE,"Begonia densifolia",4,0,4,1,5,0,0,4,1,5,"305,4km²","20,0km²"
BEGONIACEAE,"Begonia dentatiloba",0,0,0,0,0,0,0,0,0,0,n/a,n/a
BEGONIACEAE,"Begonia depauperata",13,4,17,1,13,5,0,11,7,18,"3.594,06km²","32,0km²"
BEGONIACEAE,"Begonia edmundoi",15,12,27,3,28,1,1,15,15,30,"37,85km²","28,0km²"
BEGONIACEAE,"Begonia epipsila",8,7,15,0,15,0,0,8,7,15,"32,81km²","16,0km²"
BEGONIACEAE,"Begonia erecta",0,0,0,0,0,0,0,0,0,0,n/a,n/a
BEGONIACEAE,"Begonia fabulosa",0,0,0,0,0,0,0,0,0,0,n/a,n/a
BEGONIACEAE,"Begonia fagifolia",6,20,26,0,16,10,0,6,20,26,"389,32km²","8,0km²"
BEGONIACEAE,"Begonia fluminensis",2,1,3,1,2,1,1,1,3,4,"272,99km²","4,0km²"
BEGONIACEAE,"Begonia forgetiana",0,0,0,0,0,0,0,0,0,0,n/a,n/a
BEGONIACEAE,"Begonia friburgensis",4,3,7,0,7,0,0,4,3,7,"409,03km²","12,0km²"
BEGONIACEAE,"Begonia jocelinoi",5,15,20,0,19,1,0,5,15,20,"80,79km²","12,0km²"
BEGONIACEAE,"Begonia lanstyakii",9,2,11,0,11,0,0,9,2,11,"490,52km²","8,0km²"
BEGONIACEAE,"Begonia lubbersii",1,1,2,1,1,1,1,1,2,3,"274,02km²","4,0km²"
BEGONIACEAE,"Begonia lunaris",9,6,15,0,15,0,0,9,6,15,"93,13km²","20,0km²"
BEGONIACEAE,"Begonia magdalenensis",1,3,4,0,4,0,0,1,3,4,"272,32km²","4,0km²"
BEGONIACEAE,"Begonia olsoniae",0,15,15,62,75,1,1,0,77,77,"53.833,66km²","112,0km²"
BEGONIACEAE,"Begonia parvifolia",0,0,0,9,4,5,0,0,9,9,"537,93km²","8,0km²"
BEGONIACEAE,"Begonia princeps",0,0,0,5,0,5,0,0,5,5,n/a,n/a
BEGONIACEAE,"Begonia pseudolubbersii",0,3,3,4,6,1,0,0,7,7,"5.492,99km²","12,0km²"
BEGONIACEAE,"Begonia ramentacea",0,5,5,53,44,11,3,0,58,58,"31.155,62km²","88,0km²"
BEGONIACEAE,"Begonia rotunda",0,0,0,0,0,0,0,0,0,0,n/a,n/a
BEGONIACEAE,"Begonia rubropilosa",1,5,6,15,18,3,0,1,20,21,"84.837,69km²","24,0km²"
BEGONIACEAE,"Begonia sanguinea",0,3,3,54,49,8,0,0,57,57,"182.554,97km²","112,0km²"
BEGONIACEAE,"Begonia semidigitata",0,0,0,16,14,2,0,0,16,16,"25.034,1km²","40,0km²"
BEGONIACEAE,"Begonia valida",0,4,4,4,0,7,1,0,8,8,n/a,n/a
BEGONIACEAE,"Begonia velloziana",0,0,0,2,2,0,0,0,2,2,"273,89km²","4,0km²"
BIGNONIACEAE,"Adenocalymma bullatum",1,17,18,0,8,10,0,1,17,18,"274,26km²","4,0km²"
BIGNONIACEAE,"Bignonia costata",11,41,52,0,27,25,0,6,46,52,"1.714,84km²","20,0km²"
BIGNONIACEAE,"Fridericia elegans",17,12,29,4,18,11,4,13,20,33,"8.800,42km²","32,0km²"
BIGNONIACEAE,"Jacaranda crassifolia",6,2,8,0,6,2,0,5,3,8,"44,09km²","12,0km²"
BROMELIACEAE,"Aechmea caesia",0,4,4,32,32,4,0,0,36,36,"3.187,85km²","56,0km²"
BROMELIACEAE,"Aechmea cariocae",0,6,6,15,18,3,0,0,21,21,"1.359,91km²","40,0km²"
BROMELIACEAE,"Aechmea dealbata",0,2,2,12,11,3,0,0,14,14,"16.048,35km²","24,0km²"
BROMELIACEAE,"Aechmea fasciata",0,7,7,114,104,17,0,0,121,121,"12.362,09km²","164,0km²"
BROMELIACEAE,"Aechmea grazielae",2,1,3,0,3,0,0,2,1,3,"272,19km²","4,0km²"
BROMELIACEAE,"Aechmea paratiensis",1,4,5,0,5,0,0,1,4,5,"275,82km²","4,0km²"
BROMELIACEAE,"Aechmea prava",1,0,1,0,1,0,0,1,0,1,"275,48km²","4,0km²"
BROMELIACEAE,"Aechmea squarrosa",1,9,10,0,10,0,0,1,9,10,"274,87km²","4,0km²"
BROMELIACEAE,"Alcantarea farneyi",6,10,16,0,15,1,0,6,10,16,"8,33km²","12,0km²"
BROMELIACEAE,"Alcantarea geniculata",9,29,38,1,37,2,0,9,30,39,"970,56km²","32,0km²"
BROMELIACEAE,"Alcantarea glaziouana",23,24,47,7,44,10,0,22,32,54,"1.681,74km²","76,0km²"
BROMELIACEAE,"Alcantarea heloisae",6,1,7,0,7,0,0,6,1,7,"93,84km²","20,0km²"
BROMELIACEAE,"Alcantarea martinellii",3,0,3,0,3,0,0,3,0,3,"21,29km²","8,0km²"
BROMELIACEAE,"Alcantarea nevaresii",4,3,7,0,6,1,0,4,3,7,"547,09km²","8,0km²"
BROMELIACEAE,"Alcantarea tortuosa",2,3,5,0,5,0,0,2,3,5,"272,41km²","4,0km²"
BROMELIACEAE,"Billbergia amandae",0,0,0,0,0,0,0,0,0,0,n/a,n/a
BROMELIACEAE,"Billbergia brasiliensis",0,0,0,5,5,0,0,0,5,5,"635,51km²","16,0km²"
BROMELIACEAE,"Billbergia macracantha",0,0,0,1,1,0,0,0,1,1,"273,39km²","4,0km²"
BROMELIACEAE,"Canistropsis correia-araujoi",0,0,0,3,3,0,0,0,3,3,"274,95km²","4,0km²"
BROMELIACEAE,"Canistropsis elata",0,0,0,2,2,0,0,0,2,2,"533,67km²","8,0km²"
BROMELIACEAE,"Canistropsis marceloi",0,5,5,15,20,0,0,0,20,20,"7.472,69km²","44,0km²"
BROMELIACEAE,"Canistropsis pulcherrima",0,3,3,3,6,0,0,0,6,6,"549,92km²","8,0km²"
BROMELIACEAE,"Cryptanthus bromelioides",23,15,38,0,29,9,0,22,16,38,"433,15km²","32,0km²"
BROMELIACEAE,"Cryptanthus delicatus",1,0,1,0,1,0,0,1,0,1,"272,44km²","4,0km²"
BROMELIACEAE,"Cryptanthus sinuosus",10,5,15,0,13,2,0,10,5,15,"4.629,45km²","32,0km²"
BROMELIACEAE,"Dyckia martinellii",4,6,10,0,10,0,0,4,6,10,"439,65km²","8,0km²"
BROMELIACEAE,"Dyckia pseudococcinea",0,16,16,29,42,3,0,0,45,45,"21.110,61km²","36,0km²"
BROMELIACEAE,"Neoregelia abendrothae",5,1,6,1,7,0,0,5,2,7,"489,36km²","20,0km²"
BROMELIACEAE,"Neoregelia bragarum",5,7,12,0,11,1,0,4,8,12,"547,07km²","8,0km²"
BROMELIACEAE,"Neoregelia camorimiana",1,1,2,0,1,1,0,1,1,2,"274,88km²","4,0km²"
BROMELIACEAE,"Neoregelia carinata",1,0,1,0,1,0,0,1,0,1,"273,73km²","4,0km²"
BROMELIACEAE,"Neoregelia coimbrae",4,2,6,0,6,0,0,4,2,6,"383,67km²","16,0km²"
BROMELIACEAE,"Neoregelia coriacea",3,2,5,0,5,0,0,3,2,5,"425,08km²","12,0km²"
BROMELIACEAE,"Neoregelia correia-araujoi",1,1,2,0,2,0,0,1,1,2,"274,93km²","4,0km²"
BROMELIACEAE,"Neoregelia desenganensis",1,0,1,0,1,0,0,1,0,1,"272,39km²","4,0km²"
BROMELIACEAE,"Neoregelia eltoniana",7,3,10,1,10,1,0,7,4,11,"484,47km²","24,0km²"
BROMELIACEAE,"Neoregelia fluminensis",2,1,3,0,3,0,0,2,1,3,"546,92km²","8,0km²"
BROMELIACEAE,"Neoregelia fosteriana",6,5,11,0,8,3,0,5,6,11,"37,13km²","12,0km²"
BROMELIACEAE,"Neoregelia gavionensis",1,2,3,0,3,0,0,1,2,3,"273,76km²","4,0km²"
BROMELIACEAE,"Neoregelia ilhana",1,0,1,0,1,0,0,1,0,1,"272,38km²","4,0km²"
BROMELIACEAE,"Neoregelia indecora",3,5,8,0,4,4,0,3,5,8,"739,92km²","12,0km²"
BROMELIACEAE,"Neoregelia kuhlmannii",1,3,4,0,4,0,0,1,3,4,"275,05km²","4,0km²"
BROMELIACEAE,"Neoregelia lactea",2,1,3,0,3,0,0,2,1,3,"435,35km²","8,0km²"
BROMELIACEAE,"Neoregelia leucophoea",4,4,8,0,8,0,0,4,4,8,"2.510,67km²","12,0km²"
BROMELIACEAE,"Neoregelia longipedicellata",2,0,2,0,2,0,0,2,0,2,"344,16km²","8,0km²"
BROMELIACEAE,"Neoregelia macahensis",5,3,8,0,7,1,0,5,3,8,"1.698,43km²","16,0km²"
BROMELIACEAE,"Neoregelia macwilliamsii",2,0,2,1,2,0,1,2,1,3,"550,91km²","8,0km²"
BROMELIACEAE,"Neoregelia martinellii",1,5,6,0,4,0,2,1,5,6,"275,07km²","4,0km²"
BROMELIACEAE,"Neoregelia nevaresii",1,2,3,0,3,0,0,1,2,3,"274,97km²","4,0km²"
BROMELIACEAE,"Neoregelia petropolitana",4,0,4,0,4,0,0,4,0,4,"353,32km²","12,0km²"
BROMELIACEAE,"Neoregelia roethii",0,1,1,3,2,2,0,0,4,4,"273,64km²","4,0km²"
BROMELIACEAE,"Neoregelia rubrovittata",1,0,1,0,1,0,0,1,0,1,"273,64km²","4,0km²"
BROMELIACEAE,"Neoregelia sapiatibensis",9,3,12,0,12,0,0,9,3,12,"279,1km²","16,0km²"
BROMELIACEAE,"Neoregelia tenebrosa",4,1,5,0,5,0,0,4,1,5,"8,82km²","12,0km²"
BROMELIACEAE,"Neoregelia uleana",1,2,3,0,0,3,0,0,3,3,n/a,n/a
BROMELIACEAE,"Neoregelia watersiana",1,0,1,0,1,0,0,1,0,1,"272,35km²","4,0km²"
BROMELIACEAE,"Nidularium altimontanum",11,9,20,0,20,0,0,11,9,20,"14,75km²","12,0km²"
BROMELIACEAE,"Nidularium angustifolium",10,16,26,0,26,0,0,10,16,26,"2.777,02km²","28,0km²"
BROMELIACEAE,"Nidularium apiculatum",6,1,7,0,7,0,0,6,1,7,"3,02km²","16,0km²"
BROMELIACEAE,"Nidularium atalaiaense",2,2,4,0,4,0,0,2,2,4,"320,84km²","8,0km²"
BROMELIACEAE,"Nidularium fradense",8,7,15,0,15,0,0,8,7,15,"1.928,32km²","28,0km²"
BROMELIACEAE,"Nidularium fulgens",48,23,71,0,64,7,0,48,23,71,"4.589,49km²","80,0km²"
BROMELIACEAE,"Nidularium itatiaiae",21,15,36,1,36,1,0,21,16,37,"228,73km²","44,0km²"
BROMELIACEAE,"Nidularium mangaratibense",3,0,3,0,3,0,0,3,0,3,"274,9km²","4,0km²"
BROMELIACEAE,"Nidularium organense",1,0,1,0,1,0,0,1,0,1,"273,49km²","4,0km²"
BROMELIACEAE,"Nidularium rosulatum",14,13,27,0,22,5,0,13,14,27,"6.420,56km²","40,0km²"
BROMELIACEAE,"Nidularium utriculosum",4,12,16,1,16,1,0,4,13,17,"35,78km²","12,0km²"
BROMELIACEAE,"Nidularium viridipetalum",3,3,6,0,6,0,0,3,3,6,"20,59km²","12,0km²"
BROMELIACEAE,"Pitcairnia albiflos",5,35,40,47,80,7,0,5,82,87,"209,52km²","76,0km²"
BROMELIACEAE,"Pitcairnia beycalema",2,4,6,0,3,3,0,2,4,6,"547,22km²","8,0km²"
BROMELIACEAE,"Pitcairnia corcovadensis",0,21,21,58,64,15,0,0,79,79,"63.572,36km²","76,0km²"
BROMELIACEAE,"Pitcairnia encholirioides",7,9,16,1,17,0,0,7,10,17,"39,65km²","16,0km²"
BROMELIACEAE,"Pitcairnia insularis",2,2,4,0,4,0,0,2,2,4,"274,59km²","4,0km²"
BROMELIACEAE,"Pitcairnia staminea",1,24,25,49,62,12,0,0,74,74,"17.970,26km²","68,0km²"
BROMELIACEAE,"Pitcairnia suaveolens",0,3,3,9,12,0,0,0,12,12,"100.110,82km²","44,0km²"
BROMELIACEAE,"Pitcairnia wendtiae",5,9,14,0,14,0,0,5,9,14,"295,56km²","4,0km²"
BROMELIACEAE,"Quesnelia edmundoi",2,21,23,31,51,3,0,2,52,54,"17.605,41km²","84,0km²"
BROMELIACEAE,"Quesnelia lateralis",1,23,24,109,122,11,0,1,132,133,"14.921,6km²","140,0km²"
BROMELIACEAE,"Quesnelia seideliana",0,5,5,20,20,5,0,0,25,25,"10.780,7km²","40,0km²"
BROMELIACEAE,"Tillandsia brachyphylla",19,13,32,0,28,4,0,18,14,32,"277,9km²","16,0km²"
BROMELIACEAE,"Tillandsia carminea",8,3,11,0,10,1,0,8,3,11,"128,4km²","20,0km²"
BROMELIACEAE,"Tillandsia grazielae",5,5,10,0,9,1,0,5,5,10,"1.562,2km²","12,0km²"
BROMELIACEAE,"Tillandsia neglecta",4,4,8,0,8,0,0,4,4,8,"67,32km²","12,0km²"
BROMELIACEAE,"Tillandsia nuptialis",2,3,5,0,5,0,0,2,3,5,"273,06km²","4,0km²"
BROMELIACEAE,"Tillandsia organensis",2,1,3,0,3,0,0,2,1,3,"273,8km²","4,0km²"
BROMELIACEAE,"Tillandsia reclinata",6,3,9,0,8,1,0,6,3,9,"273,78km²","4,0km²"
BROMELIACEAE,"Tillandsia roseiflora",23,1,24,0,23,1,0,23,1,24,"1.339,57km²","48,0km²"
BROMELIACEAE,"Tillandsia sucrei",5,6,11,0,6,5,0,5,6,11,"0,95km²","12,0km²"
BROMELIACEAE,"Tillandsia thiekenii",2,0,2,0,0,2,0,0,2,2,n/a,n/a
BROMELIACEAE,"Vriesea altimontana",7,8,15,4,14,5,0,7,12,19,"350,77km²","12,0km²"
BROMELIACEAE,"Vriesea altomacaensis",9,2,11,2,13,0,0,9,4,13,"42,98km²","20,0km²"
BROMELIACEAE,"Vriesea atrococcinea",0,0,0,0,0,0,0,0,0,0,n/a,n/a
BROMELIACEAE,"Vriesea bleherae",3,0,3,0,3,0,0,3,0,3,"405,94km²","8,0km²"
BROMELIACEAE,"Vriesea botafogensis",9,3,12,1,11,2,0,9,4,13,"52,2km²","20,0km²"
BROMELIACEAE,"Vriesea brassicoides",12,10,22,0,17,2,3,12,10,22,"91,95km²","20,0km²"
BROMELIACEAE,"Vriesea costae",1,3,4,0,4,0,0,1,3,4,"274,82km²","4,0km²"
BROMELIACEAE,"Vriesea croceana",1,1,2,0,2,0,0,1,1,2,"272,54km²","4,0km²"
BROMELIACEAE,"Vriesea fidelensis",1,0,1,0,1,0,0,1,0,1,"272,24km²","4,0km²"
BROMELIACEAE,"Vriesea fluminensis",4,2,6,0,5,0,1,4,2,6,"4.523,42km²","12,0km²"
BROMELIACEAE,"Vriesea fontourae",2,1,3,0,3,0,0,2,1,3,"273,81km²","4,0km²"
BROMELIACEAE,"Vriesea fradensis",9,5,14,0,13,0,1,9,5,14,"13,8km²","12,0km²"
BROMELIACEAE,"Vriesea garlippiana",3,2,5,0,5,0,0,3,2,5,"144,26km²","12,0km²"
BROMELIACEAE,"Vriesea gastiniana",1,0,1,0,1,0,0,1,0,1,"273,03km²","4,0km²"
BROMELIACEAE,"Vriesea goniorachis",21,23,44,2,34,12,0,20,26,46,"152,79km²","44,0km²"
BROMELIACEAE,"Vriesea leptantha",4,4,8,1,9,0,0,4,5,9,"9,42km²","12,0km²"
BROMELIACEAE,"Vriesea lidicensis",1,0,1,1,2,0,0,1,1,2,"548,54km²","8,0km²"
BROMELIACEAE,"Vriesea nubicola",1,2,3,0,3,0,0,1,2,3,"273,44km²","4,0km²"
BROMELIACEAE,"Vriesea pastuchoffiana",4,8,12,0,6,6,0,4,8,12,"116,77km²","12,0km²"
BROMELIACEAE,"Vriesea punctulata",5,0,5,0,5,0,0,5,0,5,"1.915,79km²","20,0km²"
BROMELIACEAE,"Vriesea rubyae",8,5,13,1,14,0,0,8,6,14,"1.144,9km²","32,0km²"
BROMELIACEAE,"Vriesea saundersii",11,10,21,3,21,3,0,11,13,24,"13.748,26km²","28,0km²"
BROMELIACEAE,"Vriesea serrana",1,0,1,0,1,0,0,1,0,1,"273,91km²","4,0km²"
BROMELIACEAE,"Vriesea sucrei",8,12,20,1,20,1,0,8,13,21,"1.408,64km²","24,0km²"
BROMELIACEAE,"Vriesea teresopolitana",5,4,9,0,9,0,0,5,4,9,"531,41km²","8,0km²"
BROMELIACEAE,"Vriesea thyrsoidea",45,28,73,1,71,3,0,45,29,74,"537,12km²","36,0km²"
BROMELIACEAE,"Vriesea triligulata",35,16,51,0,46,5,0,34,17,51,"2.318,7km²","56,0km²"
BROMELIACEAE,"Vriesea vidalii",16,8,24,0,24,0,0,16,8,24,"7,22km²","12,0km²"
BROMELIACEAE,"Vriesea warmingii",5,1,6,1,7,0,0,5,2,7,"34,87km²","16,0km²"
BROMELIACEAE,"Vriesea zildae",2,1,3,0,3,0,0,2,1,3,"273,89km²","4,0km²"
BURSERACEAE,"Tetragastris breviacuminata",13,18,31,1,27,5,0,12,20,32,"2.518,64km²","20,0km²"
CACTACEAE,"Pilosocereus ulei",11,13,24,3,18,8,1,7,20,27,"131,35km²","24,0km²"
CACTACEAE,"Rhipsalis flagelliformis",3,0,3,0,3,0,0,3,0,3,"65,44km²","12,0km²"
CACTACEAE,"Rhipsalis mesembryanthemoides",30,4,34,0,21,12,1,19,15,34,"687,07km²","48,0km²"
CACTACEAE,"Rhipsalis ormindoi",10,2,12,0,12,0,0,10,2,12,"18,72km²","16,0km²"
CACTACEAE,"Rhipsalis pentaptera",2,5,7,2,5,4,0,2,7,9,"7.846,98km²","12,0km²"
CALOPHYLLACEAE,"Kielmeyera excelsa",18,41,59,3,37,25,0,15,47,62,"59.782,68km²","36,0km²"
CALOPHYLLACEAE,"Kielmeyera gracilis",4,6,10,4,11,3,0,4,10,14,"210,87km²","16,0km²"
CALOPHYLLACEAE,"Kielmeyera insignis",2,9,11,0,9,2,0,2,9,11,"547,59km²","8,0km²"
CAMPANULACEAE,"Lobelia glazioviana",1,1,2,0,1,1,0,1,1,2,"273,82km²","4,0km²"
CAMPANULACEAE,"Lobelia santos-limae",4,2,6,0,6,0,0,4,2,6,"0,43km²","8,0km²"
CAMPANULACEAE,"Siphocampylus viscidus",1,1,2,0,2,0,0,1,1,2,"273,47km²","4,0km²"
CANELLACEAE,"Cinnamodendron sampaioanum",3,14,17,1,18,0,0,3,15,18,"493,85km²","8,0km²"
CAPPARACEAE,"Neocalyptrocalyx eichleriana",3,3,6,0,6,0,0,3,3,6,"295,26km²","4,0km²"
CELASTRACEAE,"Maytenus basidentata",4,4,8,1,3,6,0,3,6,9,"549,67km²","8,0km²"
CELASTRACEAE,"Maytenus samydaeformis",4,17,21,1,17,5,0,3,19,22,"2.256,66km²","12,0km²"
CEPHALOZIELLACEAE,"Cylindrocolea brasiliensis",1,0,1,0,1,0,0,1,0,1,"273,98km²","4,0km²"
CHRYSOBALANACEAE,"Couepia parvifolia",3,6,9,0,9,0,0,3,6,9,"20,97km²","8,0km²"
CHRYSOBALANACEAE,"Hirtella barrosoi",2,12,14,0,13,1,0,2,12,14,"274,86km²","4,0km²"
CHRYSOBALANACEAE,"Licania glazioviana",2,10,12,0,5,7,0,2,10,12,"334,25km²","8,0km²"
CLUSIACEAE,"Clusia fragrans",20,24,44,0,42,2,0,20,24,44,"504,27km²","40,0km²"
CLUSIACEAE,"Clusia immersa",22,6,28,2,30,0,0,22,8,30,"128,36km²","12,0km²"
CLUSIACEAE,"Clusia studartiana",33,2,35,4,35,0,4,33,6,39,"7.778,77km²","36,0km²"
CLUSIACEAE,"Garcinia calyptrata",3,2,5,0,2,3,0,1,4,5,"273,89km²","4,0km²"
COMBRETACEAE,"Terminalia acuminata",8,27,35,5,30,10,0,5,35,40,"276,07km²","20,0km²"
COMMELINACEAE,"Dichorisandra fluminensis",1,3,4,0,4,0,0,1,3,4,"274,33km²","4,0km²"
COMMELINACEAE,"Dichorisandra gaudichaudiana",15,7,22,0,13,9,0,9,13,22,"1.294,3km²","28,0km²"
COMMELINACEAE,"Dichorisandra nana",9,1,10,0,10,0,0,9,1,10,"240,91km²","28,0km²"
COMMELINACEAE,"Dichorisandra odorata",3,0,3,0,3,0,0,3,0,3,"476,15km²","12,0km²"
COMMELINACEAE,"Dichorisandra oxypetala",9,4,13,0,11,2,0,8,5,13,"6.207,64km²","24,0km²"
COMMELINACEAE,"Siderasis fuscata",16,11,27,0,20,7,0,12,15,27,"119,24km²","28,0km²"
CONNARACEAE,"Connarus marginatus",9,13,22,3,23,2,0,8,17,25,"1.684,19km²","24,0km²"
CONVOLVULACEAE,"Bonamia umbellata",16,0,16,0,5,11,0,5,11,16,"5,05km²","8,0km²"
CUCURBITACEAE,"Gurania cogniauxiana",0,0,0,3,3,0,0,0,3,3,"17,49km²","12,0km²"
CUCURBITACEAE,"Wilbrandia glaziovii",13,3,16,0,16,0,0,13,3,16,"1.706,28km²","28,0km²"
CYPERACEAE,"Hypolytrum glaziovii",6,15,21,4,15,10,0,6,19,25,"1.724,87km²","16,0km²"
CYPERACEAE,"Rhynchospora luetzelburgiana",0,1,1,2,1,1,1,0,3,3,"273,87km²","4,0km²"
CYPERACEAE,"Rhynchospora sampaioana",2,4,6,0,4,2,0,2,4,6,"547,97km²","8,0km²"
CYPERACEAE,"Trilepis tenuis",2,1,3,0,3,0,0,2,1,3,"470,55km²","8,0km²"
DICHAPETALACEAE,"Stephanopodium sessile",3,11,14,1,14,1,0,3,12,15,"549,76km²","8,0km²"
DICRANACEAE,"Dicranoloma brasiliense",2,1,3,0,3,0,0,2,1,3,"543,71km²","8,0km²"
DILLENIACEAE,"Davilla glaziovii",6,3,9,0,7,2,0,6,3,9,"4,08km²","8,0km²"
DIOSCOREACEAE,"Dioscorea bradei",8,4,12,1,13,0,0,8,5,13,"22,93km²","20,0km²"
DIOSCOREACEAE,"Dioscorea campanulata",1,2,3,0,1,2,0,1,2,3,"273,49km²","4,0km²"
DIOSCOREACEAE,"Dioscorea itatiaiensis",5,2,7,1,7,1,0,5,3,8,"3,1km²","12,0km²"
DIOSCOREACEAE,"Dioscorea margarethia",2,18,20,0,20,0,0,2,18,20,"337,1km²","8,0km²"
DIOSCOREACEAE,"Dioscorea oppositiflora",1,3,4,0,4,0,0,1,3,4,"274,85km²","4,0km²"
DIOSCOREACEAE,"Dioscorea organensis",1,0,1,2,3,0,0,1,2,3,"547,9km²","8,0km²"
DIOSCOREACEAE,"Dioscorea pedalis",8,2,10,0,10,0,0,8,2,10,"1,68km²","12,0km²"
DIOSCOREACEAE,"Dioscorea pumilio",0,2,2,1,1,2,0,0,3,3,"273,79km²","4,0km²"
DIOSCOREACEAE,"Dioscorea septemnervis",0,1,1,0,0,1,0,0,1,1,n/a,n/a
DIOSCOREACEAE,"Dioscorea sphaeroidea",3,0,3,0,3,0,0,3,0,3,"273,81km²","4,0km²"
DRYOPTERIDACEAE,"Ctenitis flexuosa",5,10,15,0,1,14,0,1,14,15,"273,49km²","4,0km²"
DRYOPTERIDACEAE,"Elaphoglossum mourae",1,0,1,0,0,1,0,0,1,1,n/a,n/a
ERICACEAE,"Agarista organensis",9,10,19,3,21,1,0,8,14,22,"4,92km²","16,0km²"
ERICACEAE,"Agarista uleana",22,18,40,8,41,7,0,22,26,48,"2.726,24km²","40,0km²"
ERICACEAE,"Gaylussacia pruinosa",1,8,9,0,9,0,0,1,8,9,"273,89km²","4,0km²"
ERICACEAE,"Gaylussacia retivenia",8,2,10,4,11,3,0,8,6,14,"0,47km²","12,0km²"
ERIOCAULACEAE,"Paepalanthus ovatus",12,12,24,0,21,3,0,11,13,24,"655,38km²","28,0km²"
ERYTHROXYLACEAE,"Erythroxylum cincinnatum",36,8,44,3,34,13,0,32,15,47,"4.113,72km²","48,0km²"
ERYTHROXYLACEAE,"Erythroxylum gaudichaudii",36,5,41,2,38,5,0,33,10,43,"27.454,99km²","80,0km²"
ERYTHROXYLACEAE,"Erythroxylum glazioui",21,4,25,5,25,5,0,21,9,30,"6.894,18km²","56,0km²"
ERYTHROXYLACEAE,"Erythroxylum lancifolium",15,2,17,6,22,1,0,15,8,23,"108.117,89km²","44,0km²"
ERYTHROXYLACEAE,"Erythroxylum magnoliifolium",31,3,34,6,34,6,0,26,14,40,"986,97km²","60,0km²"
ERYTHROXYLACEAE,"Erythroxylum occultum",7,0,7,2,8,1,0,7,2,9,"0,55km²","4,0km²"
ERYTHROXYLACEAE,"Erythroxylum ovalifolium",146,19,165,17,167,15,0,140,42,182,"25.269,78km²","252,0km²"
EUPHORBIACEAE,"Acalypha ampliata",0,0,0,2,2,0,0,0,2,2,"274,83km²","4,0km²"
EUPHORBIACEAE,"Acalypha aspericocca",1,1,2,0,0,2,0,0,2,2,n/a,n/a
EUPHORBIACEAE,"Acalypha peckoltii",2,0,2,0,2,0,0,2,0,2,"274,87km²","4,0km²"
EUPHORBIACEAE,"Acalypha pohliana",2,2,4,0,4,0,0,2,2,4,"273,82km²","4,0km²"
EUPHORBIACEAE,"Acalypha radicans",1,1,2,0,0,2,0,0,2,2,n/a,n/a
EUPHORBIACEAE,"Acalypha subsana",1,0,1,0,0,1,0,0,1,1,n/a,n/a
EUPHORBIACEAE,"Actinostemon mandiocanus",1,1,2,0,0,2,0,0,2,2,n/a,n/a
EUPHORBIACEAE,"Algernonia gibbosa",2,1,3,0,3,0,0,2,1,3,"275,72km²","4,0km²"
EUPHORBIACEAE,"Algernonia glazioui",2,0,2,2,3,0,1,2,2,4,"3,4km²","12,0km²"
EUPHORBIACEAE,"Algernonia paulae",27,0,27,0,27,0,0,27,0,27,"274,2km²","4,0km²"
EUPHORBIACEAE,"Bernardia brevipes",5,0,5,0,5,0,0,5,0,5,"7.379,13km²","12,0km²"
EUPHORBIACEAE,"Caperonia velloziana",1,0,1,0,1,0,0,1,0,1,"274,83km²","4,0km²"
EUPHORBIACEAE,"Croton nigricans",0,2,2,0,0,2,0,0,2,2,n/a,n/a
EUPHORBIACEAE,"Croton tenuicaulis",0,3,3,0,0,3,0,0,3,3,n/a,n/a
EUPHORBIACEAE,"Dalechampia granadilla",1,2,3,0,0,3,0,0,3,3,n/a,n/a
EUPHORBIACEAE,"Euphorbia laevigata",2,0,2,0,1,1,0,1,1,2,"274,96km²","4,0km²"
EUPHORBIACEAE,"Euphorbia sabulicola",5,7,12,0,9,3,0,5,7,12,"202,57km²","12,0km²"
EUPHORBIACEAE,"Manihot corymbiflora",6,3,9,2,7,3,1,6,5,11,"547,83km²","8,0km²"
EUPHORBIACEAE,"Ophthalmoblapton macrophyllum",24,4,28,6,18,14,2,12,22,34,"2.991,87km²","24,0km²"
EUPHORBIACEAE,"Sebastiania pteroclada",3,3,6,0,1,5,0,1,5,6,"274,81km²","4,0km²"
EUPHORBIACEAE,"Tragia peltata",1,0,1,0,0,1,0,0,1,1,n/a,n/a
FABACEAE,"Aeschynomene bradei",3,1,4,0,4,0,0,3,1,4,"120,51km²","12,0km²"
FABACEAE,"Bauhinia albicans",10,10,20,1,16,5,0,9,12,21,"535,31km²","24,0km²"
FABACEAE,"Dahlstedtia glaziovii",3,14,17,0,6,11,0,3,14,17,"273,47km²","4,0km²"
FABACEAE,"Dahlstedtia grandiflora",2,10,12,0,4,8,0,2,10,12,"547,89km²","8,0km²"
FABACEAE,"Dalbergia glaziovii",8,29,37,2,33,6,0,8,31,39,"1.208,66km²","32,0km²"
FABACEAE,"Inga arenicola",1,4,5,0,5,0,0,1,4,5,"274,7km²","4,0km²"
FABACEAE,"Inga enterolobioides",1,0,1,0,1,0,0,1,0,1,"274,89km²","4,0km²"
FABACEAE,"Luetzelburgia trialata",15,21,36,5,32,8,1,13,28,41,"3.411,62km²","36,0km²"
FABACEAE,"Lupinus dusenianus",4,0,4,2,5,1,0,4,2,6,"26,12km²","16,0km²"
FABACEAE,"Lupinus hasslerianus",0,0,0,0,0,0,0,0,0,0,n/a,n/a
FABACEAE,"Lupinus russellianus",2,0,2,2,4,0,0,2,2,4,"26,33km²","16,0km²"
FABACEAE,"Machaerium firmum",26,12,38,0,26,12,0,17,21,38,"3.876,03km²","40,0km²"
FABACEAE,"Machaerium legale",9,26,35,8,32,10,1,9,34,43,"51.032,8km²","32,0km²"
FABACEAE,"Machaerium macaense",37,16,53,0,53,0,0,37,16,53,"1.463,31km²","44,0km²"
FABACEAE,"Machaerium obovatum",35,19,54,1,46,9,0,34,21,55,"494,13km²","68,0km²"
FABACEAE,"Martiodendron fluminense",10,2,12,2,14,0,0,10,4,14,"189,07km²","12,0km²"
FABACEAE,"Mimosa ernestii",4,7,11,1,9,3,0,4,8,12,"364,13km²","12,0km²"
FABACEAE,"Mimosa glazioui",3,5,8,1,3,6,0,2,7,9,"547,38km²","8,0km²"
FABACEAE,"Moldenhawera polysperma",20,71,91,5,69,27,0,19,77,96,"78.303,15km²","60,0km²"
FABACEAE,"Ormosia altimontana",24,18,42,0,42,0,0,24,18,42,"8.788,3km²","44,0km²"
FABACEAE,"Peltogyne mattosiana",3,22,25,1,23,3,0,3,23,26,"1.826,22km²","12,0km²"
FABACEAE,"Piptadenia laxipinna",2,4,6,0,6,0,0,2,4,6,"548,02km²","8,0km²"
FABACEAE,"Piptadenia polyptera",2,8,10,4,5,9,0,1,13,14,"549,8km²","8,0km²"
FABACEAE,"Poecilanthe fluminensis",9,9,18,0,18,0,0,9,9,18,"101,66km²","12,0km²"
FABACEAE,"Senegalia miersii",10,9,19,6,22,3,0,9,16,25,"5.733,74km²","36,0km²"
FABACEAE,"Senegalia mikanii",14,9,23,1,18,5,1,11,13,24,"7.698,25km²","28,0km²"
FABACEAE,"Swartzia glazioviana",43,34,77,3,75,5,0,41,39,80,"6.536,82km²","72,0km²"
FABACEAE,"Swartzia submontana",4,2,6,0,6,0,0,4,2,6,"505,21km²","8,0km²"
FABACEAE,"Tachigali beaurepairei",15,27,42,3,27,18,0,13,32,45,"3.540,89km²","44,0km²"
FABACEAE,"Zollernia glaziovii",7,12,19,2,10,11,0,6,15,21,"1.879,2km²","28,0km²"
GENTIANACEAE,"Prepusa alata",8,4,12,0,12,0,0,8,4,12,"36,89km²","12,0km²"
GENTIANACEAE,"Prepusa connata",15,14,29,1,21,9,0,13,17,30,"362,79km²","16,0km²"
GENTIANACEAE,"Prepusa hookeriana",24,14,38,11,35,14,0,22,27,49,"6.310,73km²","52,0km²"
GERANIACEAE,"Geranium brasiliense",31,8,39,17,36,17,3,29,27,56,"5.995,37km²","36,0km²"
GESNERIACEAE,"Besleria fluminensis",2,6,8,0,8,0,0,2,6,8,"493,9km²","8,0km²"
GESNERIACEAE,"Besleria melancholica",1,0,1,192,176,17,0,1,192,193,"16.583,17km²","172,0km²"
GESNERIACEAE,"Nematanthus mirabilis",0,6,6,3,9,0,0,0,9,9,"549,19km²","8,0km²"
GESNERIACEAE,"Nematanthus pycnophyllus",0,0,0,1,1,0,0,0,1,1,"275,06km²","4,0km²"
GESNERIACEAE,"Nematanthus serpens",0,0,0,5,3,2,0,0,5,5,"485,82km²","12,0km²"
GESNERIACEAE,"Sinningia bulbosa",0,0,0,55,37,18,0,0,55,55,"4.295,83km²","84,0km²"
GESNERIACEAE,"Sinningia cardinalis",0,0,0,20,15,5,0,0,20,20,"75.389,14km²","44,0km²"
GESNERIACEAE,"Sinningia cochlearis",0,0,0,2,2,0,0,0,2,2,"547,28km²","8,0km²"
GESNERIACEAE,"Sinningia gesneriifolia",0,0,0,0,0,0,0,0,0,0,n/a,n/a
GESNERIACEAE,"Sinningia guttata",0,0,0,10,8,2,0,0,10,10,"41.501,07km²","24,0km²"
GESNERIACEAE,"Sinningia helleri",0,0,0,6,3,3,0,0,6,6,"549,02km²","8,0km²"
GESNERIACEAE,"Sinningia hirsuta",0,0,0,9,2,7,0,0,9,9,"548,39km²","8,0km²"
GESNERIACEAE,"Sinningia lateritia",0,0,0,25,24,1,0,0,25,25,"267.312,21km²","60,0km²"
GESNERIACEAE,"Sinningia lindleyi",0,0,0,16,12,4,0,0,16,16,"5.073,42km²","32,0km²"
GESNERIACEAE,"Sinningia muscicola",0,0,0,0,0,0,0,0,0,0,n/a,n/a
GESNERIACEAE,"Sinningia pusilla",0,0,0,14,11,3,0,0,14,14,"4.768,75km²","32,0km²"
GESNERIACEAE,"Vanhouttea bradeana",0,0,0,7,7,0,0,0,7,7,"1.448,46km²","16,0km²"
GESNERIACEAE,"Vanhouttea fruticulosa",0,0,0,12,12,0,0,0,12,12,"389,44km²","24,0km²"
GESNERIACEAE,"Vanhouttea gardneri",0,0,0,27,22,5,0,0,27,27,"7.136,52km²","48,0km²"
GESNERIACEAE,"Vanhouttea lanata",0,0,0,11,10,1,0,0,11,11,"10.172,37km²","24,0km²"
HELICONIACEAE,"Heliconia pseudoaemygdiana",3,3,6,0,6,0,0,3,3,6,"513,71km²","8,0km²"
IRIDACEAE,"Neomarica itatiaica",2,0,2,3,4,0,1,2,3,5,"493,71km²","8,0km²"
IRIDACEAE,"Neomarica longifolia",2,40,42,0,39,3,0,2,40,42,"547,12km²","8,0km²"
IRIDACEAE,"Neomarica northiana",9,26,35,2,36,1,0,9,28,37,"282.297,01km²","36,0km²"
IRIDACEAE,"Neomarica silvestris",17,8,25,1,23,3,0,17,9,26,"3.917,09km²","32,0km²"
IRIDACEAE,"Trimezia organensis",9,3,12,2,11,2,1,9,5,14,"459,26km²","16,0km²"
ISOETACEAE,"Isoetes goebelii",3,0,3,0,3,0,0,3,0,3,"335,48km²","8,0km²"
ISOETACEAE,"Isoetes organensis",1,1,2,0,1,1,0,1,1,2,"273,87km²","4,0km²"
ISOETACEAE,"Isoetes ulei",3,0,3,0,3,0,0,3,0,3,"274,42km²","4,0km²"
LAMIACEAE,"Hyptis cymulosa",1,1,2,0,2,0,0,1,1,2,"273,75km²","4,0km²"
LAMIACEAE,"Salvia benthamiana",9,11,20,5,17,8,0,9,16,25,"1.429,14km²","36,0km²"
LAMIACEAE,"Salvia longibracteolata",4,6,10,0,10,0,0,4,6,10,"6,56km²","12,0km²"
LAMIACEAE,"Salvia rivularis",26,14,40,2,36,6,0,24,18,42,"3.941,98km²","44,0km²"
LAMIACEAE,"Scutellaria tubiflora",0,4,4,0,1,3,0,0,4,4,n/a,n/a
LAURACEAE,"Aniba pedicellata",1,2,3,0,2,0,1,1,2,3,"273,39km²","4,0km²"
LAURACEAE,"Beilschmiedia angustifolia",15,11,26,0,22,4,0,15,11,26,"1.379,24km²","24,0km²"
LAURACEAE,"Beilschmiedia stricta",1,5,6,0,6,0,0,1,5,6,"273,97km²","4,0km²"
LAURACEAE,"Endlicheria balsamea",2,7,9,0,9,0,0,2,7,9,"274,85km²","4,0km²"
LAURACEAE,"Mezilaurus navalium",17,38,55,0,26,29,0,14,41,55,"1.891,88km²","40,0km²"
LAURACEAE,"Nectandra spicata",5,3,8,0,5,3,0,4,4,8,"686,71km²","12,0km²"
LAURACEAE,"Ocotea abbreviata",1,4,5,0,5,0,0,1,4,5,"274,87km²","4,0km²"
LAURACEAE,"Ocotea leucophloea",3,0,3,0,3,0,0,3,0,3,"274,86km²","4,0km²"
LAURACEAE,"Ocotea schwackeana",4,14,18,0,9,9,0,4,14,18,"429,29km²","16,0km²"
LAURACEAE,"Ocotea sinaiana",1,3,4,0,4,0,0,1,3,4,"273,99km²","4,0km²"
LAURACEAE,"Ocotea sulcata",10,8,18,0,18,0,0,10,8,18,"52,48km²","28,0km²"
LECYTHIDACEAE,"Couratari pyramidata",37,24,61,0,43,18,0,35,26,61,"15.063,73km²","96,0km²"
LEJEUNEACEAE,"Colura itatyana",0,0,0,1,0,1,0,0,1,1,n/a,n/a
LENTIBULARIACEAE,"Utricularia geminiloba",1,0,1,33,30,4,0,1,33,34,"12.443,74km²","64,0km²"
LOGANIACEAE,"Strychnos dantaensis",1,0,1,0,1,0,0,1,0,1,"273,73km²","4,0km²"
LOGANIACEAE,"Strychnos jacarepiensis",4,1,5,0,5,0,0,4,1,5,"445,74km²","8,0km²"
LORANTHACEAE,"Psittacanthus pluricotyledonarius",8,5,13,0,13,0,0,8,5,13,"1.375,53km²","20,0km²"
LORANTHACEAE,"Struthanthus armandianus",1,4,5,0,5,0,0,1,4,5,"274,42km²","4,0km²"
LORANTHACEAE,"Struthanthus dorothyi",1,0,1,0,1,0,0,1,0,1,"273,24km²","4,0km²"
LORANTHACEAE,"Struthanthus harlingianus",1,0,1,0,1,0,0,1,0,1,"274,85km²","4,0km²"
LORANTHACEAE,"Struthanthus involucratus",1,0,1,0,1,0,0,1,0,1,"272,37km²","4,0km²"
LORANTHACEAE,"Struthanthus maricensis",7,10,17,0,17,0,0,7,10,17,"193,2km²","20,0km²"
LORANTHACEAE,"Struthanthus pentamerus",8,2,10,0,10,0,0,8,2,10,"1.539,24km²","20,0km²"
MALPIGHIACEAE,"Banisteriopsis magdalenensis",3,0,3,0,3,0,0,3,0,3,"422,74km²","8,0km²"
MALPIGHIACEAE,"Bronwenia peckoltii",1,1,2,0,1,1,0,0,2,2,n/a,n/a
MALPIGHIACEAE,"Heteropterys occhionii",1,0,1,0,1,0,0,1,0,1,"273,88km²","4,0km²"
MALPIGHIACEAE,"Heteropterys ternstroemiifolia",20,4,24,0,22,2,0,18,6,24,"356,19km²","36,0km²"
MALPIGHIACEAE,"Janusia diminuta",1,0,1,0,1,0,0,1,0,1,"274,22km²","4,0km²"
MALPIGHIACEAE,"Stigmaphyllon affine",17,30,47,0,39,8,0,13,34,47,"8.276,28km²","44,0km²"
MALPIGHIACEAE,"Stigmaphyllon carautae",1,1,2,0,2,0,0,1,1,2,"271,08km²","4,0km²"
MALVACEAE,"Abutilon anodoides",10,7,17,1,9,9,0,7,11,18,"35,26km²","16,0km²"
MALVACEAE,"Abutilon esculentum",14,8,22,22,30,14,0,11,33,44,"104.227,49km²","64,0km²"
MALVACEAE,"Abutilon hirsutum",0,1,1,0,0,1,0,0,1,1,n/a,n/a
MALVACEAE,"Abutilon macrophyllum",2,1,3,0,2,1,0,2,1,3,"274,82km²","4,0km²"
MALVACEAE,"Byttneria beyrichiana",20,3,23,0,19,4,0,17,6,23,"1.103,04km²","16,0km²"
MALVACEAE,"Callianthe glaziovii",1,4,5,0,5,0,0,1,4,5,"273,87km²","4,0km²"
MALVACEAE,"Callianthe sellowiana",20,6,26,0,23,3,0,19,7,26,"3.893,24km²","44,0km²"
MALVACEAE,"Callianthe senilis",2,6,8,0,2,6,0,1,7,8,"273,47km²","4,0km²"
MALVACEAE,"Gaya gaudichaudiana",10,48,58,12,49,21,0,7,63,70,"3.832.741,29km²","68,0km²"
MALVACEAE,"Sida petropolitana",0,0,0,0,0,0,0,0,0,0,n/a,n/a
MALVACEAE,"Sida sampaiana",1,4,5,0,5,0,0,1,4,5,"272,41km²","4,0km²"
MARANTACEAE,"Goeppertia dorothyae",3,0,3,0,3,0,0,3,0,3,"274,5km²","4,0km²"
MARANTACEAE,"Goeppertia fatimae",4,1,5,0,5,0,0,4,1,5,"1.260,25km²","12,0km²"
MARANTACEAE,"Goeppertia grazielae",0,3,3,0,3,0,0,0,3,3,n/a,n/a
MARANTACEAE,"Goeppertia reginae",7,0,7,0,7,0,0,7,0,7,"274,79km²","4,0km²"
MARANTACEAE,"Goeppertia sphaerocephala",5,2,7,1,5,3,0,4,4,8,"3.208,11km²","20,0km²"
MARANTACEAE,"Thalia petersiana",2,0,2,1,0,3,0,0,3,3,n/a,n/a
MARCGRAVIACEAE,"Marcgravia comosa",5,1,6,2,7,1,0,5,3,8,"2.332,9km²","24,0km²"
MARCGRAVIACEAE,"Souroubea platyadenia",1,1,2,0,0,2,0,0,2,2,n/a,n/a
MELASTOMATACEAE,"Behuria cordifolia",7,3,10,0,10,0,0,7,3,10,"321,02km²","16,0km²"
MELASTOMATACEAE,"Behuria corymbosa",4,6,10,0,9,1,0,3,7,10,"374,92km²","8,0km²"
MELASTOMATACEAE,"Behuria edmundoi",2,2,4,0,4,0,0,2,2,4,"548,01km²","8,0km²"
MELASTOMATACEAE,"Behuria glazioviana",2,2,4,0,4,0,0,2,2,4,"273,44km²","4,0km²"
MELASTOMATACEAE,"Behuria huberioides",5,3,8,0,8,0,0,5,3,8,"219,02km²","16,0km²"
MELASTOMATACEAE,"Behuria limae",2,4,6,0,6,0,0,2,4,6,"272,41km²","4,0km²"
MELASTOMATACEAE,"Behuria magdalenensis",9,5,14,0,14,0,0,9,5,14,"320,01km²","8,0km²"
MELASTOMATACEAE,"Behuria mouraei",5,2,7,0,7,0,0,5,2,7,"304,09km²","4,0km²"
MELASTOMATACEAE,"Behuria organensis",10,32,42,0,41,1,0,10,32,42,"257,21km²","16,0km²"
MELASTOMATACEAE,"Bertolonia grazielae",2,0,2,0,2,0,0,2,0,2,"548,26km²","8,0km²"
MELASTOMATACEAE,"Bertolonia valenteana",2,2,4,0,4,0,0,2,2,4,"275,41km²","4,0km²"
MELASTOMATACEAE,"Bisglaziovia behurioides",4,3,7,1,4,4,0,3,5,8,"547,32km²","8,0km²"
MELASTOMATACEAE,"Clidemia raddiana",1,0,1,0,0,1,0,0,1,1,n/a,n/a
MELASTOMATACEAE,"Huberia minor",5,8,13,0,13,0,0,5,8,13,"546,42km²","8,0km²"
MELASTOMATACEAE,"Huberia parvifolia",2,7,9,0,8,1,0,2,7,9,"273,44km²","4,0km²"
MELASTOMATACEAE,"Huberia triplinervis",1,1,2,0,2,0,0,1,1,2,"273,44km²","4,0km²"
MELASTOMATACEAE,"Itatiaia cleistopetala",0,0,0,23,23,0,0,0,23,23,"84,14km²","36,0km²"
MELASTOMATACEAE,"Leandra alpestris",1,0,1,2,2,1,0,1,2,3,"298,55km²","8,0km²"
MELASTOMATACEAE,"Leandra altomacaensis",2,0,2,0,2,0,0,2,0,2,"545,75km²","8,0km²"
MELASTOMATACEAE,"Leandra atrata",1,3,4,0,4,0,0,1,3,4,"273,82km²","4,0km²"
MELASTOMATACEAE,"Leandra atroviridis",2,1,3,0,3,0,0,2,1,3,"548,31km²","8,0km²"
MELASTOMATACEAE,"Leandra breviflora",37,43,80,0,62,18,0,36,44,80,"2.367,55km²","32,0km²"
MELASTOMATACEAE,"Leandra chaetocalyx",3,0,3,0,3,0,0,3,0,3,"273,89km²","4,0km²"
MELASTOMATACEAE,"Leandra dentata",11,5,16,3,19,0,0,11,8,19,"86,09km²","24,0km²"
MELASTOMATACEAE,"Leandra depauperata",1,1,2,0,2,0,0,1,1,2,"274,03km²","4,0km²"
MELASTOMATACEAE,"Leandra freyreissii",0,0,0,1,1,0,0,0,1,1,"274,85km²","4,0km²"
MELASTOMATACEAE,"Leandra laxa",8,67,75,2,75,2,0,8,69,77,"405,44km²","20,0km²"
MELASTOMATACEAE,"Leandra magdalenensis",6,10,16,0,16,0,0,6,10,16,"251,64km²","12,0km²"
MELASTOMATACEAE,"Leandra markgrafii",1,0,1,0,1,0,0,1,0,1,"274,0km²","4,0km²"
MELASTOMATACEAE,"Leandra mollis",10,15,25,2,24,3,0,8,19,27,"54,4km²","20,0km²"
MELASTOMATACEAE,"Leandra mouraei",10,1,11,2,12,1,0,10,3,13,"10,52km²","12,0km²"
MELASTOMATACEAE,"Leandra multisetosa",6,15,21,2,23,0,0,6,17,23,"30,9km²","12,0km²"
MELASTOMATACEAE,"Leandra niangaeformis",4,20,24,2,16,10,0,3,23,26,"1.289,97km²","20,0km²"
MELASTOMATACEAE,"Leandra organensis",2,1,3,0,3,0,0,2,1,3,"381,51km²","8,0km²"
MELASTOMATACEAE,"Leandra rubida",3,4,7,2,7,0,2,3,6,9,"342,74km²","12,0km²"
MELASTOMATACEAE,"Leandra saldanhaei",1,8,9,0,9,0,0,1,8,9,"273,73km²","4,0km²"
MELASTOMATACEAE,"Leandra schwackei",1,6,7,0,3,4,0,1,6,7,"273,89km²","4,0km²"
MELASTOMATACEAE,"Leandra sessiliflora",0,2,2,1,0,3,0,0,3,3,n/a,n/a
MELASTOMATACEAE,"Leandra sphaerocarpa",3,5,8,0,8,0,0,3,5,8,"273,44km²","4,0km²"
MELASTOMATACEAE,"Leandra tetragona",1,2,3,0,3,0,0,1,2,3,"273,44km²","4,0km²"
MELASTOMATACEAE,"Meriania excelsa",10,4,14,0,12,2,0,10,4,14,"7,74km²","12,0km²"
MELASTOMATACEAE,"Meriania glabra",76,83,159,1,126,33,1,69,91,160,"9.246,35km²","92,0km²"
MELASTOMATACEAE,"Meriania glazioviana",4,4,8,0,6,2,0,3,5,8,"550,52km²","8,0km²"
MELASTOMATACEAE,"Meriania longipes",3,2,5,0,3,2,0,2,3,5,"550,52km²","8,0km²"
MELASTOMATACEAE,"Meriania robusta",30,58,88,0,84,4,0,30,58,88,"1.227,19km²","48,0km²"
MELASTOMATACEAE,"Miconia augusti",1,1,2,0,2,0,0,1,1,2,"273,44km²","4,0km²"
MELASTOMATACEAE,"Miconia cinerea",3,10,13,0,12,1,0,3,10,13,"159,42km²","12,0km²"
MELASTOMATACEAE,"Miconia dichroa",1,2,3,0,3,0,0,1,2,3,"273,44km²","4,0km²"
MELASTOMATACEAE,"Miconia eichleri",9,46,55,0,43,12,0,9,46,55,"3.226,54km²","28,0km²"
MELASTOMATACEAE,"Miconia elaeodendron",12,15,27,0,23,4,0,10,17,27,"0,02km²","8,0km²"
MELASTOMATACEAE,"Miconia fluminensis",1,1,2,0,2,0,0,1,1,2,"274,82km²","4,0km²"
MELASTOMATACEAE,"Miconia gigantea",2,8,10,0,7,3,0,1,9,10,"544,93km²","12,0km²"
MELASTOMATACEAE,"Miconia gilva",1,2,3,0,3,0,0,1,2,3,"273,39km²","4,0km²"
MELASTOMATACEAE,"Miconia glazioviana",3,9,12,0,12,0,0,3,9,12,"548,29km²","8,0km²"
MELASTOMATACEAE,"Miconia klotzschii",2,2,4,0,3,1,0,1,3,4,"275,29km²","4,0km²"
MELASTOMATACEAE,"Miconia laeta",1,4,5,0,5,0,0,1,4,5,"273,97km²","4,0km²"
MELASTOMATACEAE,"Miconia oblongifolia",1,3,4,0,4,0,0,1,3,4,"273,39km²","4,0km²"
MELASTOMATACEAE,"Miconia ovalifolia",2,8,10,0,10,0,0,2,8,10,"547,36km²","8,0km²"
MELASTOMATACEAE,"Miconia ovata",0,1,1,0,0,1,0,0,1,1,n/a,n/a
MELASTOMATACEAE,"Miconia penduliflora",7,10,17,1,14,3,1,6,12,18,"376,17km²","16,0km²"
MELASTOMATACEAE,"Miconia pseudoeichleri",1,6,7,0,0,7,0,0,7,7,n/a,n/a
MELASTOMATACEAE,"Miconia rabenii",3,0,3,0,1,2,0,1,2,3,"273,39km²","4,0km²"
MELASTOMATACEAE,"Miconia subvernicosa",13,8,21,0,21,0,0,13,8,21,"10.580,5km²","40,0km²"
MELASTOMATACEAE,"Mouriri arenicola",3,0,3,0,3,0,0,3,0,3,"351,34km²","8,0km²"
MELASTOMATACEAE,"Pleiochiton glaziovianum",4,32,36,0,35,1,0,3,33,36,"493,5km²","8,0km²"
MELASTOMATACEAE,"Pleiochiton longipetiolatum",2,1,3,0,2,1,0,2,1,3,"530,16km²","8,0km²"
MELASTOMATACEAE,"Pleiochiton magdalenense",1,1,2,0,1,1,0,1,1,2,"272,48km²","4,0km²"
MELASTOMATACEAE,"Pleiochiton micranthum",16,7,23,0,21,2,0,15,8,23,"465,77km²","8,0km²"
MELASTOMATACEAE,"Pleiochiton parvifolium",5,3,8,0,8,0,0,5,3,8,"112,65km²","16,0km²"
MELASTOMATACEAE,"Tibouchina alata",2,1,3,0,3,0,0,2,1,3,"272,46km²","4,0km²"
MELASTOMATACEAE,"Tibouchina axillaris",10,12,22,0,21,1,0,9,13,22,"1.117,09km²","28,0km²"
MELASTOMATACEAE,"Tibouchina benthamiana",10,20,30,1,17,14,0,9,22,31,"123,55km²","24,0km²"
MELASTOMATACEAE,"Tibouchina cordifolia",3,10,13,0,11,2,0,2,11,13,"390,16km²","8,0km²"
MELASTOMATACEAE,"Tibouchina cristata",5,4,9,0,9,0,0,5,4,9,"2.976,65km²","16,0km²"
MELASTOMATACEAE,"Tibouchina discolor",1,1,2,0,2,0,0,1,1,2,"272,54km²","4,0km²"
MELASTOMATACEAE,"Tibouchina elegans",3,79,82,0,73,9,0,2,80,82,"485,56km²","8,0km²"
MELASTOMATACEAE,"Tibouchina hirsutissima",8,9,17,0,15,2,0,8,9,17,"548,39km²","8,0km²"
MELASTOMATACEAE,"Tibouchina maximiliana",6,9,15,3,11,4,3,6,12,18,"547,67km²","8,0km²"
MELASTOMATACEAE,"Tibouchina pallida",4,13,17,0,13,4,0,4,13,17,"373,51km²","8,0km²"
MELASTOMATACEAE,"Tibouchina schwackei",1,7,8,0,8,0,0,1,7,8,"273,43km²","4,0km²"
MELASTOMATACEAE,"Tibouchina thereminiana",13,28,41,0,37,4,0,13,28,41,"757,26km²","32,0km²"
MELASTOMATACEAE,"Tibouchina virgata",2,15,17,0,8,9,0,2,15,17,"273,89km²","4,0km²"
MELIACEAE,"Trichilia luciae",6,2,8,0,8,0,0,6,2,8,"5,67km²","12,0km²"
MONIMIACEAE,"Grazielanthus arkeocarpus",11,0,11,0,11,0,0,11,0,11,"273,64km²","4,0km²"
MONIMIACEAE,"Macropeplus friburgensis",9,0,9,5,14,0,0,9,5,14,"50.682,54km²","28,0km²"
MONIMIACEAE,"Mollinedia acutissima",5,34,39,2,30,11,0,1,40,41,"546,46km²","8,0km²"
MONIMIACEAE,"Mollinedia corcovadensis",1,12,13,0,10,3,0,1,12,13,"274,82km²","4,0km²"
MONIMIACEAE,"Mollinedia longicuspidata",1,6,7,0,1,6,0,0,7,7,n/a,n/a
MONIMIACEAE,"Mollinedia marliae",16,5,21,1,22,0,0,16,6,22,"348,11km²","12,0km²"
MONIMIACEAE,"Mollinedia stenophylla",2,38,40,2,34,8,0,2,40,42,"273,44km²","4,0km²"
MORACEAE,"Dorstenia brevipetiolata",1,0,1,0,1,0,0,1,0,1,"274,82km²","4,0km²"
MORACEAE,"Dorstenia fischeri",2,0,2,0,2,0,0,2,0,2,"545,6km²","8,0km²"
MORACEAE,"Sorocea carautana",3,4,7,0,7,0,0,3,4,7,"10,77km²","12,0km²"
MYRTACEAE,"Calyptranthes anceps",0,0,0,2,0,2,0,0,2,2,n/a,n/a
MYRTACEAE,"Calyptranthes aromatica",0,13,13,43,45,11,0,0,56,56,"564.905,5km²","88,0km²"
MYRTACEAE,"Calyptranthes bimarginata",0,4,4,3,3,4,0,0,7,7,"1.574,19km²","12,0km²"
MYRTACEAE,"Calyptranthes caudata",0,2,2,5,3,3,1,0,7,7,"407,94km²","8,0km²"
MYRTACEAE,"Calyptranthes grandiflora",0,3,3,47,33,16,1,0,50,50,"464.584,23km²","120,0km²"
MYRTACEAE,"Calyptranthes martiusiana",0,0,0,12,5,7,0,0,12,12,"111.587,16km²","20,0km²"
MYRTACEAE,"Calyptranthes ursina",0,5,5,1,6,0,0,0,6,6,"274,15km²","4,0km²"
MYRTACEAE,"Campomanesia fruticosa",0,3,3,0,0,3,0,0,3,3,n/a,n/a
MYRTACEAE,"Campomanesia hirsuta",24,16,40,0,33,7,0,23,17,40,"4.341,15km²","48,0km²"
MYRTACEAE,"Campomanesia lundiana",1,0,1,0,0,1,0,0,1,1,n/a,n/a
MYRTACEAE,"Campomanesia mediterranea",0,2,2,0,0,2,0,0,2,2,n/a,n/a
MYRTACEAE,"Campomanesia terminalis",0,0,0,0,0,0,0,0,0,0,n/a,n/a
MYRTACEAE,"Eugenia arrabidae",0,4,4,0,0,4,0,0,4,4,n/a,n/a
MYRTACEAE,"Eugenia arvensis",0,4,4,0,2,2,0,0,4,4,n/a,n/a
MYRTACEAE,"Eugenia augustana",1,2,3,2,4,1,0,1,4,5,"0,58km²","8,0km²"
MYRTACEAE,"Eugenia brachysepala",1,0,1,0,0,1,0,0,1,1,n/a,n/a
MYRTACEAE,"Eugenia cambucae",7,6,13,0,10,3,0,5,8,13,"925,99km²","16,0km²"
MYRTACEAE,"Eugenia coccifera",1,2,3,0,2,1,0,1,2,3,"274,03km²","4,0km²"
MYRTACEAE,"Eugenia corcovadensis",8,12,20,2,20,1,1,7,15,22,"1.405,03km²","28,0km²"
MYRTACEAE,"Eugenia crenata",0,13,13,0,9,4,0,0,13,13,n/a,n/a
MYRTACEAE,"Eugenia decussata",1,1,2,2,3,1,0,0,4,4,"274,85km²","4,0km²"
MYRTACEAE,"Eugenia expansa",6,16,22,0,21,1,0,6,16,22,"16.916,32km²","16,0km²"
MYRTACEAE,"Eugenia grandifolia",4,4,8,2,2,8,0,2,8,10,"261,69km²","4,0km²"
MYRTACEAE,"Eugenia grazielae",9,5,14,0,13,1,0,9,5,14,"360,55km²","24,0km²"
MYRTACEAE,"Eugenia irirensis",1,2,3,0,3,0,0,1,2,3,"274,97km²","4,0km²"
MYRTACEAE,"Eugenia itaguahiensis",4,14,18,1,16,3,0,3,16,19,"5.100,21km²","12,0km²"
MYRTACEAE,"Eugenia kuhlmanniana",0,5,5,0,2,3,0,0,5,5,n/a,n/a
MYRTACEAE,"Eugenia marambaiensis",0,1,1,0,1,0,0,0,1,1,n/a,n/a
MYRTACEAE,"Eugenia oxyoentophylla",0,0,0,13,12,1,0,0,13,13,"7.609,45km²","32,0km²"
MYRTACEAE,"Eugenia strellensis",1,3,4,0,3,1,0,0,4,4,n/a,n/a
MYRTACEAE,"Eugenia strigipes",0,2,2,0,2,0,0,0,2,2,n/a,n/a
MYRTACEAE,"Eugenia violascens",1,0,1,0,1,0,0,1,0,1,"274,73km²","4,0km²"
MYRTACEAE,"Marlierea capitata",1,0,1,0,0,1,0,0,1,1,n/a,n/a
MYRTACEAE,"Marlierea choriophylla",3,3,6,0,5,1,0,3,3,6,"16,89km²","12,0km²"
MYRTACEAE,"Marlierea estrellensis",1,3,4,0,4,0,0,1,3,4,"274,06km²","4,0km²"
MYRTACEAE,"Marlierea guanabarina",1,0,1,1,2,0,0,1,1,2,"550,78km²","8,0km²"
MYRTACEAE,"Marlierea langsdorffii",2,5,7,1,4,3,1,2,6,8,"350,91km²","8,0km²"
MYRTACEAE,"Marlierea martinellii",5,0,5,0,5,0,0,5,0,5,"18,5km²","12,0km²"
MYRTACEAE,"Marlierea occhionii",1,1,2,1,2,1,0,1,2,3,"546,88km²","8,0km²"
MYRTACEAE,"Marlierea resupinata",1,0,1,0,1,0,0,1,0,1,"274,71km²","4,0km²"
MYRTACEAE,"Marlierea sessiliflora",1,2,3,0,0,3,0,0,3,3,n/a,n/a
MYRTACEAE,"Marlierea silvestris",0,0,0,0,0,0,0,0,0,0,n/a,n/a
MYRTACEAE,"Myrcia badia",1,1,2,0,0,2,0,0,2,2,n/a,n/a
MYRTACEAE,"Myrcia dolichopetala",2,2,4,0,3,1,0,2,2,4,"548,63km²","8,0km²"
MYRTACEAE,"Myrcia magnifolia",5,6,11,2,10,3,0,4,9,13,"551.547,12km²","16,0km²"
MYRTACEAE,"Myrcia neocambessedeana",1,3,4,0,3,1,0,0,4,4,n/a,n/a
MYRTACEAE,"Myrcia stewartiana",1,0,1,2,0,2,1,0,3,3,n/a,n/a
MYRTACEAE,"Myrcia velutiflora",6,9,15,3,16,1,1,6,12,18,"601,54km²","20,0km²"
MYRTACEAE,"Myrcia warmingiana",12,10,22,0,19,3,0,11,11,22,"100,31km²","12,0km²"
MYRTACEAE,"Myrciaria pumila",2,5,7,0,4,3,0,1,6,7,"273,48km²","4,0km²"
MYRTACEAE,"Neomitranthes apiculata",2,1,3,0,2,1,0,2,1,3,"273,44km²","4,0km²"
MYRTACEAE,"Neomitranthes riedeliana",4,7,11,0,5,6,0,3,8,11,"517,23km²","8,0km²"
MYRTACEAE,"Plinia anonyma",0,4,4,0,4,0,0,0,4,4,n/a,n/a
MYRTACEAE,"Plinia ilhensis",15,9,24,1,21,4,0,15,10,25,"1.621,72km²","56,0km²"
MYRTACEAE,"Plinia marqueteana",3,8,11,0,11,0,0,3,8,11,"100,6km²","12,0km²"
MYRTACEAE,"Plinia martinellii",10,11,21,0,18,3,0,10,11,21,"410,1km²","24,0km²"
MYRTACEAE,"Plinia sebastianopolitana",1,15,16,0,15,1,0,1,15,16,"274,86km²","4,0km²"
MYRTACEAE,"Psidium anthomega",0,1,1,0,0,1,0,0,1,1,n/a,n/a
MYRTACEAE,"Psidium arboreum",0,5,5,0,3,2,0,0,5,5,n/a,n/a
OCHNACEAE,"Luxemburgia glazioviana",22,9,31,6,28,9,0,20,17,37,"45.184,37km²","56,0km²"
OCHNACEAE,"Ouratea campos-portoi",0,0,0,4,3,1,0,0,4,4,"120,56km²","12,0km²"
OCHNACEAE,"Ouratea grandifolia",0,1,1,19,18,1,1,0,20,20,"269.134,93km²","44,0km²"
OCHNACEAE,"Ouratea miersii",0,0,0,15,8,7,0,0,15,15,"326,46km²","16,0km²"
OCHNACEAE,"Ouratea polita",0,0,0,1,1,0,0,0,1,1,"274,85km²","4,0km²"
OCHNACEAE,"Ouratea stipulata",0,4,4,58,47,15,0,0,62,62,"26.628,47km²","84,0km²"
OLACACEAE,"Cathedra grandiflora",1,2,3,0,1,2,0,1,2,3,"273,44km²","4,0km²"
OLACACEAE,"Dulacia singularis",4,1,5,27,20,12,0,4,28,32,"671.531,63km²","56,0km²"
OLEACEAE,"Chionanthus fluminensis",0,3,3,30,18,15,0,0,33,33,"1.732,11km²","32,0km²"
OLEACEAE,"Chionanthus tenuis",1,4,5,0,5,0,0,1,4,5,"274,85km²","4,0km²"
ONAGRACEAE,"Fuchsia alpestris",5,4,9,0,6,3,0,5,4,9,"160,86km²","20,0km²"
ONAGRACEAE,"Fuchsia campos-portoi",34,7,41,2,43,0,0,34,9,43,"454,67km²","36,0km²"
ONAGRACEAE,"Fuchsia glazioviana",22,4,26,4,29,1,0,22,8,30,"1.610,69km²","24,0km²"
OPILIACEAE,"Agonandra fluminensis",0,4,4,0,3,1,0,0,4,4,n/a,n/a
ORCHIDACEAE,"Acianthera bidentata",1,0,1,1,1,1,0,1,1,2,"273,79km²","4,0km²"
ORCHIDACEAE,"Acianthera exdrasii",0,1,1,0,1,0,0,0,1,1,n/a,n/a
ORCHIDACEAE,"Acianthera pavimentata",0,1,1,0,0,1,0,0,1,1,n/a,n/a
ORCHIDACEAE,"Acianthera subrotundifolia",1,1,2,0,2,0,0,1,1,2,"274,93km²","4,0km²"
ORCHIDACEAE,"Anathallis flammea",1,0,1,0,1,0,0,1,0,1,"274,07km²","4,0km²"
ORCHIDACEAE,"Anathallis githaginea",1,0,1,0,1,0,0,1,0,1,"274,86km²","4,0km²"
ORCHIDACEAE,"Anathallis lichenophila",1,0,1,0,1,0,0,1,0,1,"274,86km²","4,0km²"
ORCHIDACEAE,"Anathallis pubipetala",6,2,8,0,7,1,0,5,3,8,"1.138,67km²","16,0km²"
ORCHIDACEAE,"Anathallis rubrolimbata",1,0,1,0,1,0,0,1,0,1,"273,49km²","4,0km²"
ORCHIDACEAE,"Anathallis spannageliana",3,0,3,0,3,0,0,3,0,3,"547,28km²","8,0km²"
ORCHIDACEAE,"Baptistonia pulchella",3,3,6,0,3,3,0,3,3,6,"10,96km²","12,0km²"
ORCHIDACEAE,"Barbosella macaheensis",0,0,0,0,0,0,0,0,0,0,n/a,n/a
ORCHIDACEAE,"Brasilaelia fidelensis",2,0,2,0,2,0,0,2,0,2,"544,61km²","8,0km²"
ORCHIDACEAE,"Brasilidium dasytyle",1,1,2,0,2,0,0,1,1,2,"273,89km²","4,0km²"
ORCHIDACEAE,"Brasiliorchis heismanniana",1,1,2,0,2,0,0,1,1,2,"274,07km²","4,0km²"
ORCHIDACEAE,"Brasiliorchis polyantha",1,1,2,0,0,2,0,0,2,2,n/a,n/a
ORCHIDACEAE,"Bulbophyllum macroceras",3,4,7,0,2,5,0,2,5,7,"396,3km²","8,0km²"
ORCHIDACEAE,"Campylocentrum calostachyum",0,0,0,0,0,0,0,0,0,0,n/a,n/a
ORCHIDACEAE,"Campylocentrum organense",12,9,21,0,12,9,0,8,13,21,"2.703,73km²","20,0km²"
ORCHIDACEAE,"Catasetum globiflorum",1,3,4,0,2,2,0,0,4,4,n/a,n/a
ORCHIDACEAE,"Cattleya dormaniana",4,3,7,0,4,3,0,3,4,7,"475,06km²","8,0km²"
ORCHIDACEAE,"Centroglossa greeniana",5,4,9,0,5,4,0,4,5,9,"189,37km²","12,0km²"
ORCHIDACEAE,"Cleistes liliastrum",3,5,8,0,2,6,0,2,6,8,"273,39km²","4,0km²"
ORCHIDACEAE,"Cleistes miersii",1,2,3,0,1,2,0,1,2,3,"274,85km²","4,0km²"
ORCHIDACEAE,"Coppensia edmundoi",1,0,1,0,1,0,0,1,0,1,"272,54km²","4,0km²"
ORCHIDACEAE,"Cyclopogon gardneri",0,0,0,0,0,0,0,0,0,0,n/a,n/a
ORCHIDACEAE,"Cyclopogon proboscideus",1,2,3,0,1,2,0,0,3,3,n/a,n/a
ORCHIDACEAE,"Cyclopogon venustus",6,1,7,0,5,2,0,5,2,7,"2.244,55km²","16,0km²"
ORCHIDACEAE,"Encyclia viridiflora",1,1,2,0,0,2,0,0,2,2,n/a,n/a
ORCHIDACEAE,"Epidendrum ammophilum",9,2,11,1,9,2,1,8,4,12,"46,86km²","20,0km²"
ORCHIDACEAE,"Epidendrum goebelii",1,0,1,0,1,0,0,1,0,1,"273,39km²","4,0km²"
ORCHIDACEAE,"Epidendrum harrisoniae",3,8,11,0,5,6,0,3,8,11,"55,21km²","12,0km²"
ORCHIDACEAE,"Epistephium portellianum",2,0,2,0,0,2,0,0,2,2,n/a,n/a
ORCHIDACEAE,"Eurystyles lobata",2,0,2,0,2,0,0,2,0,2,"558,35km²","8,0km²"
ORCHIDACEAE,"Eurystyles rutkowskiana",0,1,1,0,0,1,0,0,1,1,n/a,n/a
ORCHIDACEAE,"Gomesa messmeriana",1,0,1,0,1,0,0,1,0,1,"275,72km²","4,0km²"
ORCHIDACEAE,"Habenaria gnoma",2,0,2,0,2,0,0,2,0,2,"272,49km²","4,0km²"
ORCHIDACEAE,"Hadrolaelia acuensis",0,0,0,0,0,0,0,0,0,0,n/a,n/a
ORCHIDACEAE,"Hapalorchis cymbirostris",6,0,6,0,4,2,0,4,2,6,"1.138,36km²","12,0km²"
ORCHIDACEAE,"Hapalorchis panduratus",0,0,0,0,0,0,0,0,0,0,n/a,n/a
ORCHIDACEAE,"Hoffmannseggella alvaroana",2,0,2,0,1,1,0,1,1,2,"272,41km²","4,0km²"
ORCHIDACEAE,"Lankesterella parvula",0,0,0,0,0,0,0,0,0,0,n/a,n/a
ORCHIDACEAE,"Lankesterella pilosa",1,1,2,0,2,0,0,1,1,2,"273,89km²","4,0km²"
ORCHIDACEAE,"Lankesterella spannageliana",3,0,3,0,3,0,0,3,0,3,"24,33km²","12,0km²"
ORCHIDACEAE,"Maxillaria pterocarpa",1,1,2,0,2,0,0,1,1,2,"274,07km²","4,0km²"
ORCHIDACEAE,"Miltonia flava",4,4,8,0,0,8,0,0,8,8,n/a,n/a
ORCHIDACEAE,"Octomeria aetheoantha",1,0,1,0,1,0,0,1,0,1,"274,51km²","4,0km²"
ORCHIDACEAE,"Octomeria cariocana",1,1,2,0,2,0,0,1,1,2,"274,83km²","4,0km²"
ORCHIDACEAE,"Octomeria cochlearis",6,0,6,0,4,2,0,4,2,6,"1.841,76km²","16,0km²"
ORCHIDACEAE,"Octomeria fimbriata",2,0,2,0,2,0,0,2,0,2,"547,49km²","8,0km²"
ORCHIDACEAE,"Octomeria helvola",1,0,1,0,0,1,0,0,1,1,n/a,n/a
ORCHIDACEAE,"Octomeria itatiaiae",1,0,1,0,1,0,0,1,0,1,"273,88km²","4,0km²"
ORCHIDACEAE,"Octomeria minuta",2,0,2,0,0,2,0,0,2,2,n/a,n/a
ORCHIDACEAE,"Octomeria multiflora",0,0,0,0,0,0,0,0,0,0,n/a,n/a
ORCHIDACEAE,"Octomeria pumila",0,0,0,0,0,0,0,0,0,0,n/a,n/a
ORCHIDACEAE,"Octomeria rodeiensis",5,0,5,0,3,2,0,3,2,5,"547,17km²","8,0km²"
ORCHIDACEAE,"Octomeria rodriguesii",8,2,10,0,6,4,0,5,5,10,"871,1km²","16,0km²"
ORCHIDACEAE,"Octomeria sarcophylla",3,2,5,0,4,1,0,2,3,5,"276,99km²","4,0km²"
ORCHIDACEAE,"Pabstia placanthera",0,0,0,0,0,0,0,0,0,0,n/a,n/a
ORCHIDACEAE,"Pabstiella calcarata",2,0,2,0,2,0,0,2,0,2,"547,33km²","8,0km²"
ORCHIDACEAE,"Pabstiella crassicaulis",1,0,1,0,1,0,0,1,0,1,"274,87km²","4,0km²"
ORCHIDACEAE,"Pabstiella elegantula",0,0,0,0,0,0,0,0,0,0,n/a,n/a
ORCHIDACEAE,"Pabstiella gracilicaulis",1,2,3,0,1,2,0,1,2,3,"273,58km²","4,0km²"
ORCHIDACEAE,"Pabstiella spathuliglossa",2,1,3,1,2,1,1,2,2,4,"273,73km²","4,0km²"
ORCHIDACEAE,"Pabstiella tabacina",2,0,2,0,0,2,0,0,2,2,n/a,n/a
ORCHIDACEAE,"Pelexia longibracteata",2,0,2,0,2,0,0,2,0,2,"403,24km²","8,0km²"
ORCHIDACEAE,"Pelexia luetzelburgii",3,0,3,0,2,1,0,2,1,3,"273,89km²","4,0km²"
ORCHIDACEAE,"Pelexia mouraei",1,0,1,0,0,1,0,0,1,1,n/a,n/a
ORCHIDACEAE,"Phymatidium limae",1,0,1,0,1,0,0,1,0,1,"272,54km²","4,0km²"
ORCHIDACEAE,"Pleurothallis jacarepaguaensis",1,0,1,0,0,1,0,0,1,1,n/a,n/a
ORCHIDACEAE,"Prescottia spiranthophylla",16,5,21,0,16,5,0,13,8,21,"167,14km²","40,0km²"
ORCHIDACEAE,"Prosthechea serpentilingua",0,0,0,0,0,0,0,0,0,0,n/a,n/a
ORCHIDACEAE,"Pygmaeorchis brasiliensis",1,0,1,0,1,0,0,1,0,1,"272,87km²","4,0km²"
ORCHIDACEAE,"Rauhiella brasiliensis",0,0,0,0,0,0,0,0,0,0,n/a,n/a
ORCHIDACEAE,"Rauhiella seehaweri",0,0,0,0,0,0,0,0,0,0,n/a,n/a
ORCHIDACEAE,"Rodriguezia bifolia",3,2,5,0,0,5,0,0,5,5,n/a,n/a
ORCHIDACEAE,"Rodriguezia leucantha",2,2,4,0,0,4,0,0,4,4,n/a,n/a
ORCHIDACEAE,"Rodriguezia sucrei",1,2,3,0,3,0,0,1,2,3,"274,19km²","4,0km²"
ORCHIDACEAE,"Sarcoglottis veyretiae",0,0,0,0,0,0,0,0,0,0,n/a,n/a
ORCHIDACEAE,"Sauroglossum odoratum",0,0,0,0,0,0,0,0,0,0,n/a,n/a
ORCHIDACEAE,"Sauroglossum organense",2,0,2,0,1,1,0,1,1,2,"269,4km²","4,0km²"
ORCHIDACEAE,"Specklinia hymenantha",2,3,5,0,0,5,0,0,5,5,n/a,n/a
ORCHIDACEAE,"Stelis palmeiraensis",2,2,4,0,3,1,0,1,3,4,"275,4km²","4,0km²"
ORCHIDACEAE,"Trigonidium turbinatum",1,1,2,0,0,2,0,0,2,2,n/a,n/a
ORCHIDACEAE,"Vanilla dungsii",1,0,1,0,1,0,0,1,0,1,"273,39km²","4,0km²"
ORCHIDACEAE,"Zygostates ovatipetala",3,1,4,2,3,1,2,2,4,6,"546,38km²","8,0km²"
OROBANCHACEAE,"Magdalenaea limae",4,0,4,0,4,0,0,4,0,4,"272,46km²","4,0km²"
PASSIFLORACEAE,"Passiflora farneyi",11,9,20,0,19,1,0,11,9,20,"998,76km²","28,0km²"
PASSIFLORACEAE,"Passiflora imbeana",17,4,21,0,21,0,0,17,4,21,"3.807,97km²","40,0km²"
PHYLLANTHACEAE,"Phyllanthus itatiaiensis",2,9,11,0,11,0,0,2,9,11,"273,93km²","4,0km²"
PHYLLANTHACEAE,"Phyllanthus mocotensis",1,1,2,0,2,0,0,1,1,2,"272,32km²","4,0km²"
PHYLLANTHACEAE,"Phyllanthus rosmarinifolius",8,1,9,0,8,1,0,7,2,9,"0,1km²","8,0km²"
PICRAMNIACEAE,"Picramnia grandifolia",9,1,10,0,8,2,0,8,2,10,"279,85km²","20,0km²"
PIPERACEAE,"Peperomia arbuscula",2,1,3,0,3,0,0,2,1,3,"535,18km²","8,0km²"
PIPERACEAE,"Peperomia bradei",1,11,12,0,10,2,0,1,11,12,"273,87km²","4,0km²"
PIPERACEAE,"Peperomia humifusa",1,1,2,0,2,0,0,1,1,2,"272,63km²","4,0km²"
PIPERACEAE,"Peperomia papillispica",1,5,6,0,5,1,0,1,5,6,"274,89km²","4,0km²"
PIPERACEAE,"Peperomia pubipeduncula",4,1,5,0,5,0,0,4,1,5,"35,11km²","12,0km²"
PIPERACEAE,"Peperomia riedeliana",1,1,2,0,2,0,0,1,1,2,"273,73km²","4,0km²"
PIPERACEAE,"Piper crebrinodum",1,0,1,1,1,1,0,0,2,2,"274,85km²","4,0km²"
PIPERACEAE,"Piper emygdioi",1,5,6,0,6,0,0,1,5,6,"274,6km²","4,0km²"
PIPERACEAE,"Piper giordanoi",5,8,13,0,13,0,0,5,8,13,"275,06km²","4,0km²"
PIPERACEAE,"Piper halesiifolium",2,2,4,0,2,2,0,1,3,4,"274,71km²","4,0km²"
PIPERACEAE,"Piper lundii",2,2,4,0,1,3,0,0,4,4,n/a,n/a
PIPERACEAE,"Piper morisonianum",2,5,7,0,6,1,0,1,6,7,"274,86km²","4,0km²"
PIPERACEAE,"Piper niteroiense",1,0,1,0,1,0,0,1,0,1,"274,71km²","4,0km²"
PIPERACEAE,"Piper rioense",7,7,14,0,14,0,0,7,7,14,"313,73km²","20,0km²"
PIPERACEAE,"Piper rumicifolium",1,0,1,0,1,0,0,1,0,1,"274,02km²","4,0km²"
PIPERACEAE,"Piper saldanhai",1,2,3,0,3,0,0,1,2,3,"273,79km²","4,0km²"
PIPERACEAE,"Piper translucens",33,1,34,0,34,0,0,33,1,34,"14.548,06km²","80,0km²"
PIPERACEAE,"Piper trigonodrupum",3,6,9,0,7,2,0,2,7,9,"318,73km²","8,0km²"
PIPERACEAE,"Piper weddellii",1,2,3,0,0,3,0,0,3,3,n/a,n/a
PLANTAGINACEAE,"Achetaria latifolia",2,0,2,5,5,0,2,2,5,7,"4,4km²","16,0km²"
PLANTAGINACEAE,"Ildefonsia bibracteata",7,7,14,3,10,7,0,6,11,17,"412,93km²","16,0km²"
POACEAE,"Apochloa tijucae",0,0,0,0,0,0,0,0,0,0,n/a,n/a
POACEAE,"Chusquea tenuis",1,2,3,0,2,1,0,1,2,3,"273,88km²","4,0km²"
POACEAE,"Chusquea wilkesii",1,1,2,0,0,2,0,0,2,2,n/a,n/a
POACEAE,"Dichanthelium cucaense",3,0,3,0,3,0,0,3,0,3,"547,6km²","8,0km²"
POACEAE,"Dichanthelium itatiaiae",1,5,6,0,6,0,0,1,5,6,"273,88km²","4,0km²"
POACEAE,"Dichanthelium petropolitanum",1,0,1,0,1,0,0,1,0,1,"273,77km²","4,0km²"
POACEAE,"Renvoizea glaziovii",2,12,14,1,1,14,0,1,14,15,"273,83km²","4,0km²"
POACEAE,"Renvoizea teretifolia",3,27,30,3,8,25,0,1,32,33,"2.006,17km²","12,0km²"
POACEAE,"Trisetum brasiliense",1,2,3,0,3,0,0,1,2,3,"273,88km²","4,0km²"
PODOSTEMACEAE,"Podostemum saldanhanum",11,7,18,0,8,10,0,8,10,18,"630,51km²","16,0km²"
POLYGALACEAE,"Polygala revoluta",22,11,33,0,31,2,0,21,12,33,"45,47km²","16,0km²"
POLYGONACEAE,"Coccoloba rigida",26,22,48,0,38,10,0,18,30,48,"378,05km²","32,0km²"
POLYPODIACEAE,"Moranopteris xbradei",1,0,1,0,1,0,0,1,0,1,"273,18km²","4,0km²"
POLYPODIACEAE,"Pecluma imbeana",1,3,4,0,4,0,0,1,3,4,"272,59km²","4,0km²"
POLYPODIACEAE,"Stenogrammitis luetzelburgii",2,3,5,0,2,3,0,1,4,5,"273,89km²","4,0km²"
PRIMULACEAE,"Cybianthus barrosoanus",1,0,1,0,0,1,0,0,1,1,n/a,n/a
PRIMULACEAE,"Cybianthus gracillimus",3,3,6,0,3,3,0,2,4,6,"522,9km²","8,0km²"
PRIMULACEAE,"Stylogyne araujoana",1,2,3,0,3,0,0,1,2,3,"273,98km²","4,0km²"
PRIMULACEAE,"Stylogyne leptantha",8,0,8,0,7,1,0,7,1,8,"350,14km²","24,0km²"
PRIMULACEAE,"Stylogyne sordida",4,2,6,0,4,2,0,3,3,6,"494,66km²","8,0km²"
PROTEACEAE,"Roupala gracilis",12,1,13,0,11,2,0,11,2,13,"75,02km²","24,0km²"
PTERIDACEAE,"Doryopteris magdalenensis",8,0,8,0,8,0,0,8,0,8,"50,21km²","20,0km²"
PTERIDACEAE,"Doryopteris quinquelobata",3,7,10,1,5,6,0,1,10,11,"554,93km²","8,0km²"
PTERIDACEAE,"Doryopteris subsimplex",6,9,15,0,10,5,0,5,10,15,"2.015,68km²","20,0km²"
PTERIDACEAE,"Doryopteris tijucana",13,10,23,0,23,0,0,13,10,23,"23,95km²","20,0km²"
PTERIDACEAE,"Pteris congesta",24,6,30,0,28,2,0,22,8,30,"2.232,14km²","40,0km²"
RANUNCULACEAE,"Anemone assisbrasiliana",5,1,6,0,6,0,0,5,1,6,"472,11km²","8,0km²"
RUBIACEAE,"Bathysa sylvestrae",12,7,19,0,19,0,0,12,7,19,"521,4km²","32,0km²"
RUBIACEAE,"Chomelia monantha",5,8,13,0,8,5,0,5,8,13,"418,2km²","12,0km²"
RUBIACEAE,"Chomelia transiens",0,7,7,0,1,6,0,0,7,7,n/a,n/a
RUBIACEAE,"Coussarea biflora",2,0,2,0,0,2,0,0,2,2,n/a,n/a
RUBIACEAE,"Coussarea coffeoides",6,5,11,2,10,3,0,5,8,13,"560.702,59km²","28,0km²"
RUBIACEAE,"Coussarea friburgensis",23,25,48,9,57,0,0,23,34,57,"66,11km²","28,0km²"
RUBIACEAE,"Coussarea lanceolata",0,2,2,0,0,2,0,0,2,2,n/a,n/a
RUBIACEAE,"Coussarea procumbens",0,2,2,0,2,0,0,0,2,2,n/a,n/a
RUBIACEAE,"Coussarea speciosa",3,4,7,0,3,4,0,3,4,7,"273,39km²","4,0km²"
RUBIACEAE,"Coussarea strigosipes",26,10,36,3,36,3,0,26,13,39,"3.460,27km²","48,0km²"
RUBIACEAE,"Coussarea viridis",6,12,18,1,17,2,0,6,13,19,"0,03km²","8,0km²"
RUBIACEAE,"Faramea anisodonta",1,1,2,0,1,1,0,1,1,2,"274,83km²","4,0km²"
RUBIACEAE,"Faramea aristata",1,16,17,0,15,2,0,1,16,17,"271,86km²","4,0km²"
RUBIACEAE,"Faramea australis",1,1,2,0,2,0,0,1,1,2,"275,72km²","4,0km²"
RUBIACEAE,"Faramea brachyloba",12,7,19,1,19,1,0,11,9,20,"1.318,49km²","32,0km²"
RUBIACEAE,"Faramea calyciflora",8,65,73,10,63,10,10,8,75,83,"443,61km²","16,0km²"
RUBIACEAE,"Faramea campanularis",26,6,32,1,31,2,0,26,7,33,"1.996,21km²","60,0km²"
RUBIACEAE,"Faramea cardiophylla",0,7,7,1,0,8,0,0,8,8,n/a,n/a
RUBIACEAE,"Faramea cordifolia",0,1,1,0,0,1,0,0,1,1,n/a,n/a
RUBIACEAE,"Faramea filamentosa",8,9,17,0,17,0,0,8,9,17,"151,41km²","16,0km²"
RUBIACEAE,"Faramea heteromera",1,3,4,0,2,2,0,1,3,4,"272,62km²","4,0km²"
RUBIACEAE,"Faramea includens",4,4,8,0,4,4,0,3,5,8,"1.031,84km²","12,0km²"
RUBIACEAE,"Faramea intercedens",4,3,7,0,5,2,0,4,3,7,"536,12km²","8,0km²"
RUBIACEAE,"Faramea leucocalyx",22,1,23,0,20,3,0,20,3,23,"118.133,8km²","32,0km²"
RUBIACEAE,"Faramea micrantha",1,8,9,1,5,5,0,1,9,10,n/a,n/a
RUBIACEAE,"Faramea platypoda",2,7,9,0,4,5,0,1,8,9,"274,83km²","4,0km²"
RUBIACEAE,"Faramea tinguana",6,10,16,0,8,8,0,5,11,16,"274,18km²","4,0km²"
RUBIACEAE,"Faramea urophylla",1,2,3,0,3,0,0,1,2,3,"273,13km²","4,0km²"
RUBIACEAE,"Galianthe polygonoides",4,4,8,0,6,2,0,3,5,8,"11,57km²","12,0km²"
RUBIACEAE,"Hillia saldanhaei",1,5,6,0,6,0,0,1,5,6,"273,38km²","4,0km²"
RUBIACEAE,"Hindsia arianeae",1,0,1,0,1,0,0,1,0,1,"274,03km²","4,0km²"
RUBIACEAE,"Hindsia cucullata",1,2,3,0,1,2,0,0,3,3,n/a,n/a
RUBIACEAE,"Hindsia glabra",2,26,28,4,28,0,4,2,30,32,"273,96km²","4,0km²"
RUBIACEAE,"Hindsia phyllocalyx",1,4,5,0,5,0,0,1,4,5,"273,57km²","4,0km²"
RUBIACEAE,"Hindsia republicana",1,0,1,0,1,0,0,1,0,1,"272,43km²","4,0km²"
RUBIACEAE,"Hindsia violacea",2,6,8,0,1,7,0,0,8,8,n/a,n/a
RUBIACEAE,"Ixora heterophylla",3,4,7,0,7,0,0,3,4,7,"141,65km²","12,0km²"
RUBIACEAE,"Malanea spicata",0,7,7,0,6,1,0,0,7,7,n/a,n/a
RUBIACEAE,"Manettia fimbriata",19,7,26,19,40,5,0,18,27,45,"121.089,98km²","112,0km²"
RUBIACEAE,"Manettia lutescens",1,1,2,0,1,1,0,0,2,2,n/a,n/a
RUBIACEAE,"Manettia parvula",2,7,9,0,7,2,0,2,7,9,"273,49km²","4,0km²"
RUBIACEAE,"Manettia pedunculata",11,14,25,0,11,14,0,6,19,25,"12.800,06km²","24,0km²"
RUBIACEAE,"Palicourea brasiliensis",0,2,2,1,0,3,0,0,3,3,n/a,n/a
RUBIACEAE,"Posoqueria laurifolia",2,0,2,0,2,0,0,2,0,2,"548,85km²","8,0km²"
RUBIACEAE,"Psychotria ampla",0,2,2,0,2,0,0,0,2,2,n/a,n/a
RUBIACEAE,"Psychotria brachyandra",0,3,3,0,2,1,0,0,3,3,n/a,n/a
RUBIACEAE,"Psychotria brachyanthema",0,1,1,0,0,1,0,0,1,1,n/a,n/a
RUBIACEAE,"Psychotria caudata",7,16,23,0,23,0,0,7,16,23,"28,25km²","20,0km²"
RUBIACEAE,"Psychotria clavipes",0,12,12,0,5,7,0,0,12,12,n/a,n/a
RUBIACEAE,"Psychotria densicostata",1,3,4,0,2,2,0,1,3,4,"274,85km²","4,0km²"
RUBIACEAE,"Psychotria lindleyana",2,1,3,0,0,3,0,0,3,3,n/a,n/a
RUBIACEAE,"Psychotria lucidifolia",1,0,1,0,1,0,0,1,0,1,"274,74km²","4,0km²"
RUBIACEAE,"Psychotria mandiocana",1,5,6,0,2,4,0,1,5,6,"274,08km²","4,0km²"
RUBIACEAE,"Psychotria subspathacea",55,29,84,0,69,15,0,50,34,84,"29.400,88km²","48,0km²"
RUBIACEAE,"Psychotria sutericalyx",1,0,1,0,0,1,0,0,1,1,n/a,n/a
RUBIACEAE,"Psychotria tenuinervis",49,15,64,0,61,3,0,47,17,64,"2.463,03km²","60,0km²"
RUBIACEAE,"Psychotria ulei",16,6,22,0,20,2,0,15,7,22,"989,13km²","28,0km²"
RUBIACEAE,"Psychotria vestita",1,0,1,0,0,1,0,0,1,1,n/a,n/a
RUBIACEAE,"Psychotria wilkesiana",2,3,5,0,0,5,0,0,5,5,n/a,n/a
RUBIACEAE,"Randia itatiaiae",5,4,9,0,9,0,0,5,4,9,"0,62km²","8,0km²"
RUBIACEAE,"Rudgea discolor",3,7,10,0,9,1,0,2,8,10,"548,95km²","8,0km²"
RUBIACEAE,"Rudgea erythrocarpa",11,19,30,0,21,9,0,9,21,30,"2.856,66km²","28,0km²"
RUBIACEAE,"Rudgea insignis",12,10,22,0,13,9,0,8,14,22,"11.931,13km²","28,0km²"
RUBIACEAE,"Rudgea macrophylla",71,28,99,0,90,9,0,65,34,99,"4.027,25km²","72,0km²"
RUBIACEAE,"Rudgea parvifolia",4,5,9,0,5,4,0,2,7,9,"273,81km²","4,0km²"
RUBIACEAE,"Rustia simpsonii",3,3,6,0,6,0,0,3,3,6,"40,64km²","12,0km²"
RUBIACEAE,"Standleya erecta",1,4,5,0,4,1,0,1,4,5,"272,59km²","4,0km²"
RUBIACEAE,"Standleya limae",2,3,5,0,5,0,0,2,3,5,"272,59km²","4,0km²"
RUTACEAE,"Conchocarpus grandiflorus",3,0,3,1,3,1,0,3,1,4,"69,73km²","12,0km²"
RUTACEAE,"Conchocarpus ovatus",42,27,69,0,57,12,0,39,30,69,"3.721,34km²","56,0km²"
RUTACEAE,"Conchocarpus paniculatus",3,8,11,0,6,5,0,2,9,11,"546,95km²","8,0km²"
RUTACEAE,"Conchocarpus sordidus",11,10,21,1,19,3,0,10,12,22,"13.469,25km²","28,0km²"
SALICACEAE,"Abatia microphylla",4,1,5,4,6,3,0,3,6,9,"7.261,63km²","24,0km²"
SAPINDACEAE,"Allophylus exappendiculatus",0,0,0,0,0,0,0,0,0,0,n/a,n/a
SAPINDACEAE,"Allophylus heterophyllus",17,25,42,59,65,36,0,12,89,101,"38.173,59km²","80,0km²"
SAPINDACEAE,"Allophylus membranifolius",0,3,3,23,22,4,0,0,26,26,"871.314,2km²","64,0km²"
SAPINDACEAE,"Cupania fluminensis",0,1,1,15,13,3,0,0,16,16,"4.553,82km²","32,0km²"
SAPINDACEAE,"Cupania schizoneura",0,2,2,6,5,3,0,0,8,8,"4.115,75km²","16,0km²"
SAPINDACEAE,"Matayba leucodyctia",0,0,0,2,2,0,0,0,2,2,"546,86km²","8,0km²"
SAPINDACEAE,"Matayba talisioides",0,4,4,1,1,4,0,0,5,5,"274,83km²","4,0km²"
SAPINDACEAE,"Paullinia marginata",0,10,10,26,24,12,0,0,36,36,"378.355,8km²","60,0km²"
SAPINDACEAE,"Serjania acuminata",0,1,1,1,1,1,0,0,2,2,"272,67km²","4,0km²"
SAPINDACEAE,"Serjania fluminensis",0,3,3,8,10,1,0,0,11,11,"1.025,07km²","28,0km²"
SAPINDACEAE,"Serjania hamuligera",0,0,0,3,1,2,0,0,3,3,"274,69km²","4,0km²"
SAPINDACEAE,"Serjania itatiaiensis",0,0,0,1,1,0,0,0,1,1,"274,03km²","4,0km²"
SAPINDACEAE,"Serjania littoralis",0,0,0,8,8,0,0,0,8,8,"28,82km²","20,0km²"
SAPINDACEAE,"Serjania truncata",0,0,0,3,1,2,0,0,3,3,"273,98km²","4,0km²"
SAPOTACEAE,"Pradosia glaziovii",2,3,5,0,1,4,0,1,4,5,"274,34km²","4,0km²"
SELIGERIACEAE,"Brachydontium notorogenes",1,0,1,0,1,0,0,1,0,1,"273,91km²","4,0km²"
SOLANACEAE,"Capsicum friburgense",4,2,6,0,6,0,0,4,2,6,"1,6km²","8,0km²"
SOLANACEAE,"Solanum friburgense",2,2,4,0,4,0,0,2,2,4,"471,86km²","8,0km²"
SPHAGNACEAE,"Sphagnum amoenum",1,2,3,0,2,1,0,1,2,3,"274,82km²","4,0km²"
SPHAGNACEAE,"Sphagnum costae",0,0,0,3,3,0,0,0,3,3,"414,47km²","8,0km²"
SPHAGNACEAE,"Sphagnum luetzelburgii",1,0,1,0,1,0,0,1,0,1,"273,87km²","4,0km²"
SPHAGNACEAE,"Sphagnum scorpioides",0,0,0,0,0,0,0,0,0,0,n/a,n/a
SPHAGNACEAE,"Sphagnum subhomophyllum",1,0,1,0,1,0,0,1,0,1,"273,83km²","4,0km²"
SPHAGNACEAE,"Sphagnum triporosum",1,1,2,0,2,0,0,1,1,2,"273,91km²","4,0km²"
SYMPLOCACEAE,"Symplocos altissima",1,4,5,2,3,4,0,1,6,7,"546,14km²","8,0km²"
SYMPLOCACEAE,"Symplocos dasyphylla",2,9,11,3,2,12,0,2,12,14,"895,63km²","12,0km²"
SYMPLOCACEAE,"Symplocos glaziovii",1,11,12,0,2,10,0,1,11,12,"273,49km²","4,0km²"
SYMPLOCACEAE,"Symplocos neglecta",3,17,20,0,19,1,0,3,17,20,"546,88km²","8,0km²"
SYMPLOCACEAE,"Symplocos occulta",0,0,0,1,1,0,0,0,1,1,"273,81km²","4,0km²"
SYMPLOCACEAE,"Symplocos organensis",6,11,17,7,14,10,0,5,19,24,"232,9km²","12,0km²"
THELYPTERIDACEAE,"Thelypteris refracta",8,2,10,1,8,3,0,7,4,11,"3.895,63km²","20,0km²"
THISMIACEAE,"Thismia caudata",0,0,0,2,0,2,0,0,2,2,n/a,n/a
THISMIACEAE,"Thismia fungiformis",0,0,0,2,0,2,0,0,2,2,n/a,n/a
THISMIACEAE,"Thismia macahensis",0,0,0,0,0,0,0,0,0,0,n/a,n/a
THYMELAEACEAE,"Funifera brasiliensis",0,0,0,84,67,17,0,0,84,84,"72.483,43km²","72,0km²"
THYMELAEACEAE,"Funifera insulae",6,2,8,0,6,2,0,5,3,8,"288,64km²","4,0km²"
TRIGONIACEAE,"Trigonia littoralis",9,1,10,0,10,0,0,9,1,10,"1.187,56km²","16,0km²"
TRIGONIACEAE,"Trigonia rotundifolia",0,0,0,19,17,1,1,0,19,19,"39.108,21km²","44,0km²"
TRIURIDACEAE,"Peltophyllum caudatum",1,2,3,0,1,2,0,1,2,3,"274,85km²","4,0km²"
TRIURIDACEAE,"Triuris alata",2,1,3,1,3,1,0,2,2,4,"274,1km²","4,0km²"
VELLOZIACEAE,"Barbacenia brevifolia",7,11,18,0,14,4,0,6,12,18,"59,89km²","16,0km²"
VELLOZIACEAE,"Barbacenia fanniae",4,2,6,0,6,0,0,4,2,6,"347,47km²","8,0km²"
VELLOZIACEAE,"Barbacenia foliosa",0,0,0,0,0,0,0,0,0,0,n/a,n/a
VELLOZIACEAE,"Barbacenia gaveensis",7,4,11,0,9,2,0,7,4,11,"0,1km²","8,0km²"
VELLOZIACEAE,"Barbacenia seubertiana",7,20,27,0,4,23,0,2,25,27,"518,83km²","8,0km²"
VELLOZIACEAE,"Barbacenia squamata",3,1,4,0,4,0,0,3,1,4,"59,54km²","12,0km²"
VIOLACEAE,"Rinorea laevigata",20,49,69,2,55,16,0,17,54,71,"982,52km²","60,0km²"
VOCHYSIACEAE,"Callisthene dryadum",3,32,35,0,34,1,0,3,32,35,"274,84km²","4,0km²"
XYRIDACEAE,"Xyris organensis",4,2,6,0,5,1,0,4,2,6,"69,46km²","12,0km²"
Calophyllaceae,"Kielmeyera aureovinosa",7,1,8,0,8,0,0,7,1,8,"0,85km²","8,0km²"
Bromeliaceae,"Vriesea eltoniana",21,17,38,1,39,0,0,21,18,39,"1.097,74km²","24,0km²"
Orchidaceae,"Brasilaelia lobata",11,5,16,0,9,7,0,9,7,16,"57,68km²","16,0km²"
BEGONIACEAE,"Begonia sylvestris",11,1,12,0,10,2,0,10,2,12,"665,56km²","32,0km²"
BEGONIACEAE,"Begonia arborescens",100,19,119,114,181,50,2,93,140,233,"71.847,57km²","200,0km²"
FABACEAE,"Mimosa bocainae",7,2,9,0,8,1,0,7,2,9,"117,56km²","12,0km²"
Melastomataceae,"Pleroma cleistoflorae",0,0,0,0,0,0,0,0,0,0,n/a,n/a
BEGONIACEAE,"Begonia bonitoensis",16,1,17,0,17,0,0,16,1,17,"47,66km²","24,0km²"
Ditrichaceae,"Ditrichum itatiaiae",0,0,0,3,0,0,3,0,3,3,n/a,n/a
FABACEAE,"Mimosa itatiaiensis",10,5,15,1,12,4,0,9,7,16,"453,89km²","24,0km²"
ARACEAE,"Anthurium sakuraguianum",2,0,2,0,2,0,0,2,0,2,"392,46km²","8,0km²"
ARACEAE,"Philodendron luisae",1,0,1,0,1,0,0,1,0,1,"273,81km²","4,0km²"
ARACEAE,"Anthurium cronembergerae",4,0,4,0,3,1,0,3,1,4,"29,35km²","12,0km²"
Poaceae,"Glaziophyton mirable",0,0,0,0,0,0,0,0,0,0,n/a,n/a
MALPIGHIACEAE,"Hiraea restingae ",0,0,0,0,0,0,0,0,0,0,"3.629,9km²","36,0km²"
ORCHIDACEAE,"Pabstiella purpurea",0,0,0,0,0,0,0,0,0,0,n/a,n/a
LOASACEAE,"Aosa uleana",8,2,10,0,7,3,0,6,4,10,"32,29km²","16,0km²"
BEGONIACEAE,"Begonia tomentosa",9,9,18,0,11,7,0,9,9,18,"15,87km²","12,0km²"
MORACEAE,"Ficus nevesiae",21,11,32,0,30,2,0,20,12,32,"13.295,74km²","56,0km²"
ORCHIDACEAE,"Brasiliorchis moutinhoi",1,0,1,0,1,0,0,1,0,1,"273,87km²","4,0km²"
CACTACEAE,"Schlumbergera russelliana",18,3,21,22,32,9,2,17,26,43,"682,65km²","44,0km²"
